"BOBBY ""BORIS"" PICKETT"	male
"BRUNO MARS, ANDERSON .PAAK & SILK SONIC"	male
"GALANTIS, DAVID GUETTA & LITTLE MIX"	male
'TIL TUESDAY	male
10CC	male
13TH FLOOR ELEVATORS	male
16 TAMBOURINES	male
1910 FRUITGUM COMPANY	male
1975 (THE)	male
2 UNLIMITED	male
2AM	male
3 AMIGOS	male
3 JAYS	male
38 SPECIAL	male
4 NON BLONDES	male
5 STAR	male/female
5TH DIMENSION	male
808 STATE	male
911	male
A CERTAIN RATIO	male
A FLOCK OF SEAGULLS	male
A TASTE OF HONEY	male/female
A VERY GOOD FRIEND FEAT. JOY	male
A-HA	male
A1	male
AALIYAH	male
AARON NEVILLE	male
ABBA	male/female
ABC	male
AC/DC	assume_female
ACE	male
ACE OF BASE	male
ACKER BILK	male
AD BROWN AND MATT LANGE	male
AD LIBS	male/female
ADAM AND THE ANTS	male
ADAM ANT	male
ADAM FAITH	male
ADAM RICKITT	male
ADAM SNYDER	male
ADAMSKI	male
ADEVA	female
ADIEMUS	male
ADRIAN GURVITZ	male
ADVENTURES	male
ADVENTURES OF STEVIE V	male
Advert:	male/female
AEROSMITH	male
AFRICANISM	male
AFROJACK	male
AFTER THE FIRE	male
AGNETHA FALTSKOG	female
Aha	assume_female
Aidan Moffat	assume_female
AIR SUPPLY	male
AL GREEN	male
AL GREEN WITH ANNIE LENNOX	male/female
AL JARREAU	male
AL MARTINO	male
AL STEWART	male
ALABAMA	male
ALAN BOWN SET	male
ALAN PARSONS PROJECT	male
ALAN PRICE SET	male
ALAN SORRENTI	male
ALAN WALKER	male
ALANIS MORISSETTE	male
ALANNAH MYLES	male
ALARM	male
ALBERT COLLINS	male
ALBERT HAMMOND	male
ALBERT KING	male
ALCAZAR	male
ALDO NOVA	male
ALED JONES	male
ALED JONES AND SIR TERRY WOGAN	male
ALEX PARKS	male
ALEXANDER O'NEAL	male
ALEXANDER O'NEAL AND CHERELLE	male
ALEXIS JORDAN	female
Alfie Zappacosta	assume_female
ALFRED MARKS	male
ALIAS	male
ALICE BOMAN	female
ALICE COOPER	male
ALICE IN CHAINS	male
ALICE MARTINEAU	female
ALICIA KEYS	female
ALISHAS ATTIC	female
ALISON KRAUSS	female
ALISON KRAUSS AND UNION STATION	male/female
ALISON LIMERICK	female
ALISON MOYET	female
ALL ABOUT EVE	male
ALL SAINTS	female
ALLMAN BROTHERS BAND	male
ALMA COGAN	female
ALPHABEAT	male
ALPHAVILLE	male
ALTERED IMAGES	male/female
Alvin and the Chipmunks	assume_female
ALVIN CASH & THE CRAWLERS	male
ALVIN ROBINSON	male
AMAZULU	male/female
AMBROSIA	male
AMEN	male
AMEN CORNER	male
AMEN UK	male
AMERICA	male
AMII STEWART	female
Amy Grant	assume_female
AMY STUDT	female
ANASTACIA	female
ANDREA TRUE CONNECTION	male
ANDREW GOLD	male
ANDREWS SISTERS	female
ANDY KIM	male
ANDY WILLIAMS	male
ANEKA	female
ANGEL WITCH	female
ANGELIQUE KIDJO	female
ANGELS	male
ANGLOS	male
ANGRY ANDERSON	male
Animal Nightlife	assume_female
ANIMALS	male
ANIMOTION	male
ANITA BAKER	female
ANITA HARRIS	female
ANITA WARD	female
ANN MARGARET	female
ANN PEEBLES	female
ANNE MURRAY	female
ANNE SHELTON	female
ANNIE LENNOX	female
Annie Lennox & Al Green	male/female
ANNIE LENNOX FEAT. PAUL SIMON	male/female
ANOTHER LEVEL	male
ANT AND DEC	male
ANTHONY NEWLEY	male
APPLEJACKS	male/female
APPLETON	male
APRIL WINE	male
AQUA	male
AQUA VELVA	male
AQUALUNG	male
ARCADIA	male
ARCHIE BELL AND THE DRELLS	male
ARCHIES	male
ARCHITECHS FEAT. NANA	male/female
ARETHA FRANKLIN	female
ARETHA FRANKLIN AND GEORGE BENSON	female
ARETHA FRANKLIN AND GEORGE MICHAEL	female
Aretha Franklin/george Michael	male/female
ARGENT	male
ARID	male
ARLO GUTHRIE	male
ARRIVAL	male
ARROWS	male
ART GARFUNKEL	male
ART OF NOISE FEAT. TOM JONES	male
Art Of Noise Ft Max Headroom	assume_female
ARTFUL DODGER FEAT. LIFFORD	male
ARTFUL DODGER FEAT. ROMINA JOHNSON	male
ARTHUR CONLEY	male
ARTIST UNITED FOR NATURE	male
ASH	male
ASHAYE	male
ASHFORD AND SIMPSON	male
ASIA	male
ASSOCIATES	male
ASSOCIATION	male
ASWAD	male
ATHLETE	male
ATLANTA RHYTHM SECTION	male
ATLANTIC STARR	male
ATOMIC KITTEN	female
ATOMIC ROOSTER	male
ATTACK	male
ATTIC LIGHTS	male
Audioenhance	assume_female
Audioenhance Tease Commercial	assume_female
AURORA	male
AUSTIN FAITHFULL	male
AUTOMATIC	male
AVA MAX	female
AVERAGE WHITE BAND	male
AVICII	male
AVIS	male
AVONS	female
AVRIL LAVIGNE	female
Axel F	assume_female
AZTEC CAMERA	male
AZURE RAY	male
AZZIDO DA BASS	male
B WITCHED	female
B-52'S	male
B. BUMBLE AND THE STINGERS	male
B.B. AND Q. BAND	male
B.B. KING	male
B52s	male/female
BABY D	male
BABY WASHINGTON	male
BABYBIRD	male
BABYLON ZOO	male
BABYS	male
BACHELORS	male
BACHMAN TURNER OVERDRIVE	male
BACKSTREET BOYS	male
BAD COMPANY	male
BAD ENGLISH	male
BAD MANNERS	male
BADLY DRAWN BOY	male
BAJA MARIMBA BAND	male
BALITO CREPE MIST STOCKINGS	male
BALLOON FARM	male
BALTIMORA	male/female
BANANARAMA	female
Bananarama   [Partymix]	assume_female
BANANARAMA WITH FUN BOY THREE	male/female
BAND	male
BAND AID	male
BAND AID 20	male
BAND AID 2004	male
BAND OF BEES	male
BANGLES	female
BAR-KAYS	male
BARBARA ACKLIN	female
BARBARA ANN	female
BARBARA DICKSON	female
BARBARA DICKSON AND ELAINE PAIGE	female
BARBARA LEWIS	female
BARBARA LYNN	female
BARBARA MASON	female
BARBARA MCNAIR	female
BARBARA RANDOLPH	female
BARBARIANS	male
BARBRA STREISAND	female
BARBRA STREISAND & BARRY GIBB	male/female
BARCLAY JAMES HARVEST	male
BARDO	female
BARENAKED LADIES	male
BARRACUDAS	male
BARRETT STRONG	male
BARRY BENSON	male
BARRY BLUE	male
BARRY GRAY ORCHESTRA	male
BARRY MANILOW	male
BARRY MCGUIRE	male
BARRY WHITE	male
BASEMENT JAXX (FEAT. LISA KEKAULA)	male
BASTILLE	male
BAY CITY ROLLERS	male
Bb & Q Band	male/female
BB AND Q BAND	male
BBE	male
BBMAK	male
Be A Part Of 80splanet	assume_female
BE BOP DELUXE	male
BE GOOD TANYAS	female
BEACH BOYS	male
BEACH-NUTS	male
BEAN AND LOOPY'S LOT	male
BEAT	male
BEATCHUGGERS FEAT. ERIC CLAPTON	male
BEATFREAKZ	male
BEATLES	male
BEATLES WITH TONY SHERIDAN	male
BEATMASTERS	male
BEATMASTERS FEAT. MC MERLIN	male
BEATS INTERNATIONAL	male
BEATS INTERNATIONAL FEAT. LINDY LAYTON	male
BEAUTIFUL SOUTH	male
BEDROCKS	male
BEE GEES	male
BEGGAR AND CO	male
BELFAST GYPSIES	male
BELINDA CARLISLE	female
BELLAMY BROTHERS	male
BELLE STARS	female
BELLEFIRE	male
BELOUIS SOME	male
BELOVED	male
BEN E. KING	male
BEN JELEN	male
BEN PRESTON	male
BEN'S BROTHER	male
BENNY CARTER	male
BENNY GOODMAN	male
Benny Hill	assume_female
BENNY SPELLMAN	male
BERLIN	male
BERN ELLIOTT AND THE FENMEN	male
BERRI	male
BERT JANSCH	male
BERT KAEMPFERT	male
BERT WEEDON	male
Bertie Higgins	assume_female
BETH NIELSEN CHAPMAN	female
BETH ORTON	female
BETTE MIDLER	female
BETTY BOO	female
BETTY EVERETT	female
BEVERLEY ANN	female
BEVERLEY CRAVEN	female
BEVERLEY SISTERS	female
Beverly Craven	assume_female
BEVERLY KNIGHT FEAT. REDMAN	female
BIBLE	male
BIG AUDIO DYNAMITE	male
BIG BOPPER	male
BIG BROTHER AND THE HOLDING COMPANY	male
BIG C CLUB	male
BIG COUNTRY	male
BIG DEE IRWIN	male
BIG FUN	male
BIG MOUNTAIN	male
BIG SOUND AUTHORITY	male
BIG SUGAR	male
BIG THREE	male
BILL BLACK'S COMBO	male
BILL HALEY AND HIS COMETS	male
BILL HALEY AND THE COMETS	male
BILL LOVELADY	male
Bill Medley And Jennifer Warnes	male/female
BILL WITHERS	male
BILLIE	female
BILLIE ANTHONY	female
BILLIE DAVIS	female
BILLIE JO SPEARS	female
BILLIE MYERS	female
BILLIE PIPER	female
BILLY ECKSTINE	male
BILLY ECKSTINE AND SARAH VAUGHAN	male/female
BILLY FURY	male
BILLY GRIFFIN	male
BILLY IDOL	male
BILLY J. KRAMER	male
BILLY J. KRAMER AND THE DAKOTAS	male
BILLY JOE ROYAL	male
BILLY JOEL	male
BILLY MAY	male
BILLY OCEAN	male
BILLY PAUL	male
BILLY PRESTON	male
Billy Preston And Syreeta	male/female
BILLY RAY CYRUS	male
BILLY SQUIER	male
BILLY STEWART	male
BILLY SWAN	male
BILLY WILLIAMS	male
BING CROSBY	male
BING CROSBY AND DAVID BOWIE	male
BIRDS	male
BIZARRE	male
BIZARRE INC.	male
BJORK	female
BJORN AGAIN	male
BLACK	male
BLACK BOX	male
BLACK CROWES	male
BLACK EYED PEAS	male
Black Lace	assume_female
BLACK LEGEND	male
BLACK SABBATH	male
BLACK SLATE	male
BLACK VELVET	male
BLACKFOOT	male
BLACKFOOT SUE	male
BLANCMANGE	male
BLAS CANTÓ	male
BLAZIN' SQUAD	male
BLESSID UNION OF SOULS	male
BLONDIE	male/female
BLOOD SWEAT & TEARS	male
BLOOD SWEAT AND TEARS	male
BLOODHOUND GANG	male
BLOSSOMS	female
BLOW MONKEYS	male
BLUE	male
BLUE AEROPLANES	male
BLUE BOY	male
BLUE CHEER	male
BLUE MAGOOS	male
BLUE MERCEDES	male
BLUE MINK	male
BLUE NILE	male
BLUE OYSTER CULT	male
BLUE PEARL	male
BLUE RONDOS	male
BLUE SUEDE	male
BLUE THINGS	male
BLUE ZOO	male
BLUEBELLS	male
Blues Brothers	assume_female
BLUES TRAVELER	male
BLUETONES	male
BLUR	male
BO STREET RUNNERS	male
BOB AND EARL	male
Bob B Soxx And The Blue Jeans	assume_female
BOB B. SOXX AND THE BLUE JEANS	male
BOB CREWE GENERATION	male
BOB DYLAN	male
BOB LEAPER ORCHESTRA	male
BOB LIND	male
BOB MARLEY	male
BOB MARLEY AND THE WAILERS	male
Bob Seger	assume_female
BOB SEGER AND THE SILVER BULLET BAND	male
BOB SINCLAR	male
Bob The Builder	assume_female
BOBBIE GENTRY	female
BOBBIE GENTRY AND GLEN CAMPBELL	male/female
Bobby Boris Pickett & The Crypt Kickers	assume_female
BOBBY BROWN	male
BOBBY CURTOLA	male
BOBBY DARIN	male
BOBBY DAY	male
BOBBY FULLER FOUR	male
BOBBY GOLDSBORO	male
BOBBY HEBB	male
BOBBY HELMS	male
BOBBY MCFERRIN	male
BOBBY THURSTON	male
BOBBY VEE	male
BOBBY WOMACK	male
BODYSNATCHERS	male
BOMB THE BASS	male
Bomb The Bass [PartyMix]	male/female
BOMBAY BICYCLE CLUB	male
BOMFUNK MC'S	male
BON JOVI	male
BONEY M	male
BONNIE RAITT	female
BONNIE TYLER	female
BONZO DOG DOO-DAH BAND	male
BOO RADLEYS	male
BOOGIE BOX HIGH	male
BOOKER T & THE MG'S	male
BOOKER T AND THE MG'S	male
BOOMTOWN RATS	male
BORIS GARDINER	male
BORIS PICKETT	male
BOSTON	male
BOSTON CRABS	male
BOURGEOIS TAGG	male
BOW WOW WOW	male
BOX TOPS	male
BOY GEORGE	male
BOY MEETS GIRL	male
BOYS DON'T CRY	male
Boys Dont Cry	assume_female
BOYS TOWN GANG	male
BOYZ TO MEN	male
BOYZONE	male
BOZ	male
BOZ SCAGGS	male
BRAND	male
BRAND NEW HEAVIES	male
BRANDON FLOWERS	male
BRANDS	male
BRANDY	female
BRASS CONSTRUCTION	male
BREAD	male
Break Machine	assume_female
Breakfast Club	assume_female
BREATHE	male
BRENDA HOLLOWAY	female
BRENDA LEE	female
BRENDA RUSSELL	female
BRENDAN BENSON	male
BRENTON WOOD	male
BRIAN ENO	male
BRIAN HYLAND	male
BRIAN KENNEDY	male
BRIAN MAY	male
BRIAN MCFADDEN	male
BRIAN MCFADDEN AND DELTA GOODREM	male/female
BRIAN POOLE AND THE TREMELOES	male
BRIGHTON	male
BRITNEY SPEARS	female
BROADSIDE	male
BROKEN ENGLISH	male
BRONSKI BEAT	male
BROOK BENTON	male
BROOKLYN BRIDGE	male
BROS	male
BROTHER BEYOND	male
BROTHERHOOD OF MAN	male
BROTHERS	male
BROTHERS IN RHYTHM	male
BROTHERS JOHNSON	male
BRUCE CHANNEL	male
BRUCE COCKBURN	male
BRUCE HORNSBY	male
Bruce Hornsby And The Range	assume_female
BRUCE SPRINGSTEEN	male
BRUCE WILLIS	male
BRYAN ADAMS	male
Bryan Adams And Tina Turner	male/female
BRYAN FERRY	male
Bryan Ferry And Roxy Music	assume_female
BUCKS FIZZ	male/female
BUDDY HOLLY	male
BUDDY HOLLY AND THE CRICKETS	male
BUDDY KNOX	male
BUFFALO SPRINGFIELD	male
BUFFY SAINTE-MARIE	female
BUGGLES	male
BURL IVES	male
BURT BACHARACH	male
BURT BACHARACH & HIS ORCHESTRA FEATURING TONY MIDD	male
BUSTED	male
BUTTHOLE SURFERS	male
BUZZCOCKS	male
BWO	male
BYRDS	male
BYSTANDERS	male
CADILLACS	male
CALIFORNIANS	male
CALLING	male
CALUM SCOTT	male
CALVIN HARRIS	male
CALVIN JAMES	male
CAMEO	male
Cameo   [PartyMix]	assume_female
CAMISRA	male
CANDI STATON	female
CANNED HEAT	male
CAPITOLS	male
CAPTAIN	male/female
Captain & Tennille	male/female
CAPTAIN AND TENNILLE	male/female
CAPTAIN SENSIBLE	male
CARAVELLES	male
CARDIGANS	male/female
CARL DOUGLAS	male
CARL PERKINS	male
CARLA BRUNI	male
CARLY SIMON	female
CARMEL	male
CAROL CONNORS	female
CAROLE BAYER SAGER	female
CAROLE KING	female
CAROLYN CARTER	female
CARON WHEELER	female
CARPENTERS	male/female
CARROLLS	male
CARS	male
CARTER WOOD	male
CARTOONS	male
CASCADES	male
CASUALS	male
CAT STEVENS	male
CATATONIA	male/female
CATHY DENNIS	female
CATS	male
CAUSES	male
CCS	male
CE CE PENISTON	female
CELINE DION	female
Cerrone	assume_female
CEVIN FISHER FEAT RAMONA KELLER	male
CHAIRMAN OF THE BOARD	male
CHAKA KHAN	male
CHAMBERS BROTHERS	male
CHAMPAIGN	male
CHAMPS	male
CHANCES ARE	male
CHANGE	male
CHANNELS	male
CHANTS	female
CHARLATANS	male
CHARLENE	female
CHARLES & EDDIE	male
CHARLES BOYER	male
CHARLES DICKENS	male
CHARLIE DANIELS BAND	male
Charlie Dore	assume_female
CHARLIE GRACIE	male
CHARLIE RICH	male
CHARLOTTE OC	female
Chas N Dave	assume_female
CHASE & STATUS	male
CHEAP TRICK	male
CHER	female
CHERRELLE	female
Cherrelle And Alexander O'neal	male/female
CHERRY GHOST	male
CHERYL COLE	female
CHESNEY HAWKES	male
CHET BAKER	male
CHI LITES	male
CHIC	male
CHICAGO	male
CHICKEN SHACK	male
CHICKEN SHED THEATRE	male/female
CHIFFONS	male
CHILLIWACK	male
CHIMES	male
CHINA BLACK	male
CHINA CRISIS	male
CHORDETTES	male
CHORDS	male
CHRIS ANDREWS	male
CHRIS BROWN	male
CHRIS CLARK	male
CHRIS DE BURGH	male
CHRIS FARLOWE	male
CHRIS ISAAK	male
Chris K	assume_female
CHRIS MONTEZ	male
CHRIS REA	male
CHRIS SPEDDING	male
CHRIS THOMPSON	male
CHRISSIE HYNDE	female
CHRISTIANS	male
CHRISTINA AGUILERA	female
CHRISTINE AND THE QUEENS	female
CHRISTINE MCVIE	female
CHRISTOPHER CROSS	male
CHROMATICS	male
CHUBBY CHECKER	male
CHUCK BERRY	male
CHUMBAWAMBA	male
CHURCH	male
CILLA BLACK	female
CINDERELLA	female
CITY BOY	male
CLAMARAN ANTOINE PRESENTS D-PLAC	male
CLANNAD	male/female
CLARENCE CLEMONS	male
CLARENCE FROGMAN HENRY	male
CLASH	male
CLASSICS IV	male
CLASSIX NOUVEAUX	male
CLEAN BANDIT	male
CLEAN BANDIT FEAT. ZARA LARSSON	male/female
CLIFF BENNETT AND THE REBEL ROUSERS	male
CLIFF RICHARD	male
Cliff Richard & The Young Ones	assume_female
Cliff Richard And Olivia Newton John	male/female
CLIFF RICHARD AND PHIL EVERLY	male
CLIFFORD T. WARD	male
CLIMAX BLUES BAND	male
CLIMIE FISHER	male
CLINTON FORD	male
CLODAGH RODGERS	female
CLOUT	male
CLOVERS	male
CLOVES	male
CLUB NOUVEAU	male
CLYDE MCPHATTER	male
COAST TO COAST	male
COASTERS	male
COCK ROBIN	male
CODY SIMPSON	male
COLA BOY	male
Coldcut Feat Yazz	male/female
COLDPLAY	male
COLDPLAY & BTS	male
COLIN BLUNSTONE	male
COLLEGE AND ELECTRIC YOUTH	male
COLONEL ABRAMS	male
COLOUR ME BADD	male
COLOURFIELD	male
COMMODORES	male
COMMUNARDS	male
CONNELLS	male
CONNIE FRANCIS	female
CONNIE STEVENS	female
CONTI MUNTI	male
CONTOURS	male
CONWAY TWITTY	male
CORAL	male
COREY HART	male
Corey Heart	assume_female
CORNERSHOP	male
CORRS	male/female
COSMIC ROUGH RIDERS	male
COUGARS	male
COUNT FIVE	male
COUNTING CROWS	male
COUNTRY JOE AND THE FISH	male
COVERDALE PAGE	male
COWSILLS	male/female
COZY POWELL	male
CRAIG DAVID	male
CRAIG DOUGLAS	male
CRAIG MCLACHLAN	male
CRAIG PHILLIPS	male
CRAMPS	male
CRANBERRIES	male/female
CRASH TEST DUMMIES	male
CRAVING	male
CRAZY ELEPHANT	male
CRAZY WORLD OF ARTHUR BROWN	male
CREAM	male
CREATION	male
CREEDENCE CLEARWATER REVIVAL	male
CRESTS	male
CREW CUTS	male
CRICKETS	male
CRISPIAN ST PETERS	male
CRITTERS	male
CROSBY STILLS AND NASH	male
CROWDED HOUSE	male
CROWN HEIGHTS AFFAIR	male
CRUSADERS	male
CRYIN' SHAMES	male
CRYSTAL GAYLE	female
CRYSTALS	female
CULT	male
CULTURE CLUB	male
CULTURE SHOCK	male
CUNNINGHAM	male
CUPIDS INSPIRATION	male
CURE	male
CURIOSITY KILLED THE CAT	male
CURTIS LEE	male
CURTIS MAYFIELD	male
CURTIS MAYFIELD AND THE IMPRESSIONS	male
CURTIS STIGERS	male
CURVED AIR	male
CUTTING CREW	male
CYNDI LAUPER	female
CYRKLE	male
D TRAIN	male
D-SIDE	male
D;REAM	male
DA MUTTZ	male
DAFT PUNK	male
DAKOTA STATON	male
DAKOTAS	male
DALBELLO	male
DALTON BOYS	male
DAMAGE	male
Damian	assume_female
DAMIEN RICE	male
DAMN YANKEES	male
Damned	assume_female
DAN FOGELBERG	male
DAN HARTMAN	male
DAN HILL	male
DAN REED NETWORK	male
Dana	assume_female
DANA VALERY	male
DANDY WARHOLS	male
DANIEL BEDINGFIELD	male
DANIEL BOONE	male
DANIEL POWTER	male
DANNII	female
DANNII MINOGUE	female
DANNY & THE JUNIORS	male
DANNY DAY	male
DANNY MIRROR	male
DANNY O'KEEFE	male
DANNY WILLIAMS	male
DANNY WILSON	male
DARIO G	male
DARIUS	male
DARKNESS	male
DARLENE LOVE	female
DARLENE LOVE AND THE E STREET BAND	female
DARLING BUDS	male/female
DARRELL BANKS	male
DARROW FLETCHER	male
DARUDE	male
DARYL HALL	male
DAVE BERRY	male
DAVE CLARK FIVE	male
DAVE DAVIES	male
DAVE DEE DOZY BEAKY MICK & TICH	male
DAVE DEE DOZY BEAKY MICK AND TICH	male
DAVE EDMUNDS	male
DAVE EDMUNDS AND LOVE SCULPTURE	male
DAVE KING	male
DAVE MASON	male
DAVE STEWART	male
Dave Stewart & Barbara Gaskin	male/female
DAVE STEWART AND BARBARA GASKIN	male/female
Dave Stewart Ft. Candy Dulfer	male/female
DAVID & DAVID	male
DAVID A STEWART	male
DAVID AND JONATHAN	male
DAVID BOWIE	male
DAVID BOWIE AND MICK JAGGER	male
DAVID BOWIE AND THE LOWER THIRD	male
David Bowie with Bing Crosby	assume_female
DAVID BOX	male
DAVID CASSIDY	male
DAVID CHRISTIE	male
DAVID DUNDAS	male
DAVID ESSEX	male
DAVID GARRICK	male
DAVID GATES	male
DAVID GRANT AND JAKI GRAHAM	male/female
DAVID GRAY	male
DAVID HASSELHOFF	male
DAVID JORDAN	male
DAVID KNOPFLER	male
DAVID LEE ROTH	male
DAVID LINDLEY	male
DAVID MCWILLIAMS	male
DAVID MEAD	male
DAVID PARTON	male
DAVID ROSE ORCHESTRA	male
DAVID SNEDDON	male
DAVID SOUL	male
DAVID SYLVIAN	male
DAVID WHITFIELD	male
DAVIE JONES AND THE KING BEES	male
DAZZ BAND	male
DB BOULEVARD	male
DE LA SOUL	male
DE NUIT	male
DEACON BLUE	male
DEAD OR ALIVE	male
DEAN LEWIS	male
DEAN MARTIN	male
DEAN MARTIN & HELEN O'CONNELL	male/female
DEAN PARRISH	male
DEBARGE	male
DEBBIE GIBSON	female
DEBBIE HARRY	female
DEBBIE HARRY & IGGY POP	male/female
DEBBIE REYNOLDS	female
Dee C Lee	assume_female
DEE C. LEE	female
DEE CLARK	female
DEE MULLINS	female
DEEP BLUE SOMETHING	male
DEEP PURPLE	male
Def Leppard	assume_female
DEL AMITRI	male
DEL SHANNON	male
DEL VIKINGS	male
DEL-VIKINGS	male
DELANEY & BONNIE	male/female
DELANEY & BONNIE & FRIENDS	male/female
DELFONICS	male
DELIRIUM FEAT. SARAH MCLACHLAN	male/female
DELLA REESE	female
DELTA GOODREM	female
DENIECE WILLIAMS	female
DENNIS EDWARDS FEAT. SIEDAH GARRET	male
DENNIS LOTIS	male
DENNIS TURNER	male
DENNISONS	male
DEPARTMENT S	male
DEPECHE MODE	male
DEREK AND THE DOMINOS	male
DEREK GARDNER	male
DERRICK AND PATSY	male
DERRICK HARRIOTT	male
DESIRE	male
DESIRELESS	male
DESMOND DEKKER AND THE ACES	male
DESREE	female
DESTINY'S CHILD	male
DETROIT EMERALDS	male
DETROIT SPINNERS	male
Devo	assume_female
DEXYS MIDNIGHT RUNNERS	male
Dhar Braxton	assume_female
DIAMONDS	male
DIANA CARROLL	female
DIANA KING	female
DIANA ROSS	female
DIANA ROSS AND LIONEL RICHIE	male/female
DIANA ROSS AND THE SUPREMES	male/female
DICK DALE AND HIS DELTONES	male
DICK JAMES	male
DICKEY LEE	male
DICKIE VALENTINE	male
DIDO	female
DILLINGER	male
DINA CARROLL	female
DINAH SHORE	female
DINOSAUR JR.	male
DION	male
DION & THE BELMONTS	male
DIONNE WARWICK	female
Dionne Warwick And Friends	male/female
DIONNE WARWICK AND LUTHER VANDROS	female
Dionne Warwick, Geoffrey Osbourne	male/female
DIRE STRAITS	male
DIRTY DOZEN BRASS BAND FEAT. NORAH JONES	male
DISCLOSURE	male
DISCO TEX & THE SEX-O-LETTES	male
DISSOCIATIVES	male
DIVINE	male
DIVINE COMEDY	male
DIVINYLS	male
DIXIE CHICKS	female
DIXIE CUPS	female
DJ DISCIPLE	male
DJ JAZZY JEFF & THE FRESH PRINCE	male
DJ QUICKSILVER	male
DJ ROLANDO A.K.A. AZTEC MYSTIC	male
DJ SAKIN AND FRIENDS	male
DJ SAMMY	male
DMA'S	male
DOBIE GRAY	male
DOC HOLLIDAY	male
Doctor & The Medics	assume_female
DOCTOR AND THE MEDICS	male
DODGY	male
DOGS DIE IN HOT CARS	male
DOLLAR	male/female
DOLLY PARTON	female
DOLLY PARTON AND KENNY ROGERS	female
DON AND DEWEY	male
DON FARDON	male
DON HENLEY	male
DON HENLEY & BRUCE HORNSBY	male
Don Henley And Bruce Hornsby	assume_female
DON JOHNSON	male
DON LANG	male
DON MCLEAN	male
DON PARTRIDGE	male
Donald Fagan	assume_female
DONALD FAGEN	male
Donna Allen	assume_female
DONNA LEWIS	female
DONNA SUMMER	female
DONNIE ELBERT	male
DONOVAN	male
DOOBIE BROTHERS	male
DOOLALLY	male
DOORS	male
DOPE SMUGGLAZ	male
DORIAN GRAY	male
DORIS DAY	female
DORIS TROY	female
DOROTHY MOORE	female
DOROTHY SQUIRES	female
DORSEY BURNETTE	male
DOUBLE	male
DOWLANDS	male
DOWNBEATS	male
DOWNLINERS SECT	male
DR ALBAN	male
Dr And The Medics	assume_female
DR FEELGOOD	male
DR HOOK	male
Dr. Hook	assume_female
DREAM ACADEMY	male
DRIFTERS	male
DRIZA BONE	male
DUANE EDDY	male
DUANE HARDEN	male
DUFFY POWER	male
DUKE ELLINGTON	male
DUNCAN BROWNE	male
DUNCAN FAURE	male
DUNCAN JAMES	male
DURAN DURAN	male
DUSTY SPRINGFIELD	female
DYNAMICS	male
E L O	assume_female
E-17	male
E.L.O	male
EAGLE EYE CHERRY	male
EAGLES	male
EARL VAN DYKE & THE SOUL BROTHERS	male
EARTH & FIRE	male
EARTH WIND & FIRE	male
Earth Wind And Fire	male/female
Eartha Kitt	assume_female
EASYBEATS	male
ECHO	male
ECHO AND THE BUNNYMEN	male
ECHOBELLY	male
ECHOSMITH	male
ECLIPSE	male
ED HARCOURT	male
ED SHEERAN	male
EDDIE & THE HOT RODS	male
EDDIE CALVERT	male
EDDIE COCHRAN	male
EDDIE FISHER	male
EDDIE FLOYD	male
Eddie Grant	assume_female
EDDIE HODGES	male
EDDIE HOLMAN	male
EDDIE MONEY	male
EDDIE MURPHY & RICK JAMES	male
EDDIE RABBITT	male
EDDY ARNOLD	male
EDDY GRANT	male
EDEN KANE	male
EDIE BRICKELL & THE NEW BOHEMIANS	male
Edie Brickell And New Bohemians	assume_female
Edie Brickell And The New Bohemians	assume_female
EDISON LIGHTHOUSE	male
EDWARD BEAR	male
EDWIN HAWKINS SINGERS	male
EDWIN MCCAIN	male
EDWIN STARR	male
EDWYN COLLINS	male
EELS	male
EG	male
EIGHTH WONDER	male
El Debarge	assume_female
EL PRESIDENTE	male
Elaine Paige & Barbara Dickson	assume_female
ELASTICA	male
ELBOW	male
ELECTRIC	male
Electric Light Orchestra	assume_female
ELECTRIC PRUNES	male
ELECTRIC SIX	male
ELECTRONIC	male
ELGINS	male
ELIAS AND HIS ZIG ZAGS	male
ELIDA	male
ELIZABETH GOTTEN & BRENDA EVANS	female
ELKIE BROOKS	female
ELLA FITZGERALD	female
ELLIE CAMPBELL	female
ELLIE GOULDING	female
ELTON JOHN	male
ELTON JOHN & KIKI DEE	male/female
ELVIN BISHOP	male
ELVIS COSTELLO	male
ELVIS PRESLEY	male
EMBRACE	male
EMF	male
EMILE FORD & THE CHECKMATES	male
EMILIA	female
EMMA BUNTON	female
EMMA REDE	female
EMMYLOU HARRIS	female
EMMYLOU HARRIS & MARK KNOPFLER	male/female
EMOTIONS	male
EMPIRE OF THE SUN	male
EN VOGUE	male
ENGELBERT HUMPERDINCK	male
ENGINEERS	male
ENGLAND DAN & JOHN FORD COLEY	male
ENGLAND SISTERS	female
ENGLISH BEAT	male
ENIGMA	male
ENNIO MORRICONE	male
ENRIQUE IGLESIAS	male
ENYA	female
EPHRAIM LEWIS	male
EPISODE SIX	male
EQUALS	male
ERASURE	male
ERIC BURDON	male
ERIC BURDON & THE ANIMALS	male
ERIC CARMEN	male
ERIC CLAPTON	male
ERIC PRYDZ	male
ERMA FRANKLIN	female
ERNIE K-DOE	male
ERNIE MARESCA	male
ERROL DUNKLEY	male
Escape Club	assume_female
ESCORTS	male
ESSEX	male
ESTHER & ABI OFARIM	male/female
ESTHER PHILLIPS	female
ETERNAL	male
ETHIOPIANS	male
ETTA JAMES	male
EUROPE	male
EURYTHMICS	male/female
EURYTHMICS & ARETHA FRANKLIN	male/female
EVA CASSIDY	female
EVAN DANDO	male
EVANESCENCE	male
EVE BOSWELL	female
EVELYN 'CHAMPAGNE' KING	female
EVELYN THOMAS	female
EVERCLEAR	male
EVERLY BROTHERS	male
EVERYTHING BUT THE GIRL	male/female
EWAN & JERRY	male
EXILE	male
ExposÃ©	assume_female
EXPOSE	male
EXTREME	male
F.R. DAVID	male
FABULOUS THUNDERBIRDS	male
FACES	male
FACTOTUMS	male
FAIRGROUND ATTRACTION	male
FAIRPORT CONVENTION	male
FAITH HILL	female
FAITH NO MORE	female
FAITHLESS	male
Falco	assume_female
FAMILY	male
FAMILY DOGG	male
FANTASTICS	male
FAR CORPORATION	male
FARM	male
FASHION	male
FAT LARRY'S BAND	male
Fat Larrys Band	assume_female
FATBACK BAND	male
FATBOY SLIM	male
Fatboys	assume_female
FATHER JACK	male
FATS DOMINO	male
FEARGAL SHARKEY	male
FEDERALS	male
FEEDER	male
FEELING	male
FELICE TAYLOR	female
FELIX	male
Female 80s	assume_female
Female Best 80s	assume_female
Female Drop	assume_female
Female Vo	assume_female
Female Whisper?	assume_female
FERN KINNEY	female
FFITCH	male
FICTION FACTORY	male
FIERCE	male
FIFTH AVENUE	male
FINE YOUNG CANNIBALS	male
FINIS HENDERSON	male
FINK	male
FINLEY QUAYE	male
FINN BROTHERS	male
FIRST CLASS	male
FIRST EDITION	male
FISCHER-Z	male
FIVE	male
FIVE FOR FIGHTING	male
FIVE KEYS	male
FIVE MAN ELECTRICAL BAND	male
FIVE SATINS	male
FIVE STAR	male/female
FIXX	male
FLAMING LIPS	male
FLAMINGOS	male
FLAMMA SHERMAN	male
FLASH & THE PAN	male
Flash And The Pan	assume_female
FLASHDANCE	male
FLEET FOXES	male
FLEETWOOD MAC	male/female
FLEETWOODS	male
FLETCHER HENDERSON	male
FLIES	male
FLIRTATIONS	female
Flock Of Seagulls	assume_female
FLORENCE + THE MACHINE	female
FLOWER POT MEN	male
FLOYD ROBINSON	male
FLUKE	male
FLYING LIZARDS	male
FLYING PICKETS	male
FOALS	male
FOCUS	male
FONTELLA BASS	female
FOO FIGHTERS	male
FORCE MD'S	male
FORCE WEST	male
FOREIGNER	male
FORREST	male
FORTUNES	male
FOSTER THE PEOPLE	male
FOUNDATIONS	male
FOUNTAINHEAD	male
FOUNTAINS OF WAYNE	male
FOUR ACES	male
FOUR FRESHMEN	male
FOUR PENNIES	male
FOUR PREPS	male
FOUR SEASONS	male
FOUR TOPS	male
FOURMOST	male
FOXES	female
FPI PROJECT	male
FRAGMA	male
FRANCE GALL	male
FRANCES	female
FRANCES NERO	female
FRANCOISE HARDY	female
FRANK IFIELD	male
FRANK SINATRA	male
FRANK WILSON	male
FRANKIE AVALON	male
FRANKIE GOES TO HOLLYWOOD	male
FRANKIE KNUCKLES	male
FRANKIE LAINE	male
FRANKIE LYMON & THE TEENAGERS	male
FRANKIE MILLER	male
FRANKIE VALLI	male
FRANKIE VAUGHAN	male
FRANKMUSIK	male
FRAY	male
FRAZIER CHORUS	male
FREAKS OF NATURE	male
FREDA PAYNE	female
FREDDIE AND THE DREAMERS	male
FREDDIE BELL AND THE BELLBOYS	male
FREDDIE JACKSON	male
FREDDIE LENNON	male
Freddie Mcgregor	assume_female
Freddie Mercury	assume_female
FREDDIE RYDER	male
FREDDY CANNON	male
FREE	male
FREEEZ	male
Freeeze	male/female
FREEMAN BROTHERS	male
FREIHEIT	male
FREUR	male
FRIDA	female
FRIDA & PHIL COLLINS	male/female
FRIEND & LOVER	male
FRIENDS OF DISTINCTION	male
FRIJID PINK	male
FRITZ KALKBRENNER	male
FSN	assume_female
FUN BOY 3	male
Fun Boy Three	assume_female
FUN BOY THREE FEAT. BANANARAMA	male
FUN LOVIN' CRIMINALS	male
FURNITURE	male
GABRIELLE	female
GALAXY	male
GALE GARNETT	male
GALLAGHER & LYLE	male
GAP BAND	male
GARBAGE	male
GARETH GATES	male
GARNET MIMMS	male
GARY BARLOW	male
GARY BARLOW & ELTON JOHN	male
GARY BARLOW & THE COMMONWEALTH BAND	male
GARY BROOKER	male
Gary Byrd And The Gb Experience	assume_female
GARY EDWARDS COMBO	male
GARY KEMP	male
GARY LEWIS AND THE PLAYBOYS	male
GARY MILLER & THE BARRY GRAY ORCHESTRA	male
GARY MILLER WITH RAY MARTIN'S CHORUS AND ORCHESTRA	male
GARY MOORE	male
GARY NUMAN	male
GARY PUCKETT AND THE UNION GAP	male
GARY US BONDS	male
GARY WRIGHT	male
GAS COMPANY	male
GAYLETS	male
GAYLORDS	male
Gaz	assume_female
Gaz Dry	assume_female
GAZEBO	male
GEMMA HAYES	female
GEMS	female
GENE	male
GENE CHANDLER	male
GENE LOVES JEZEBEL	male
GENE PITNEY	male
GENE VINCENT	male
GENERATION X	male
Generic Costingless	assume_female
GENESIS	male
GENO WASHINGTON & THE RAM JAM BAND	male
GEORDIE	male
GEORGE ACOSTA	male
GEORGE BAKER SELECTION	male
GEORGE BENSON	male
GEORGE BENSON & VICKI RANDALL	male/female
GEORGE EZRA	male
GEORGE HARRISON	male
GEORGE MCCRAE	male
GEORGE MICHAEL	male
GEORGE SHEARING QUINTET	male
George Thorogood	assume_female
GEORGE THOROGOOD & THE DESTROYERS	male
GEORGIA SATELLITES	male
GEORGIE FAME	male
GERALD ALSTON	male
GERARD KENNY	male
GERI HALLIWELL	female
GERRY AND THE PACEMAKERS	male
GERRY RAFFERTY	male
GHOSTS	male
GIBSON BROTHERS	male
GIBSON GUITARS	male
GIBSONS	male
GIFTCO	male
GIGOLO AUNTS	male
GILBERT O'SULLIVAN	male
GILLAN	male
GIN BLOSSOMS	male
GIORGIO MORODER WITH PHILIP OAKEY	male
GIRL THING	male
GIRLS ALOUD	female
GIRLS HERE FIRST	female
GLADYS KNIGHT	female
GLADYS KNIGHT & THE PIPS	male/female
GLASS TIGER	male
GLEN CAMPBELL	male
Glen Goldsmith	assume_female
GLEN JONES	male
Glen Medeiros	assume_female
GLENFLEX INSTANT SKIRTS	male
GLENN FREY	male
GLENN MEDEIROS	male
GLENN MILLER	male
GLITTER BAND	male
GLORIA ESTEFAN	female
Gloria Estefan And Miami Sound Machine	assume_female
GLORIA ESTEFAN AND THE MIAMI SOUND MACHINE	male/female
GLORIA GAYNOR	female
GLORIA JONES	female
GLORIA LYNNE	female
GNARLS BARKLEY	male
Go Go's	assume_female
Go Gos	assume_female
GO WEST	male
GO-BETWEENS	male
Go-Go's	assume_female
GODLEY & CREME	male
GOGO'S	female
GOLDEN EARRING	male
GOLDFRAPP	male
GOLDIE	female
GOLDIE & THE GINGERBREADS	female
GOLDSPOT	male
GONZALES	male
GOO GOO DOLLS	female
GOOD CHARLOTTE	female
GORDON LIGHTFOOT	male
GRACE JONES	female
GRACIE FIELDS	female
GRAHAM BOND ORGANISATION	male
GRAHAM BONNET	male
GRAHAM BONNEY	male
GRAND DRIVE	male
GRAND FUNK RAILROAD	male
GRANDADDY	male
GRANDMASTER FLASH	male
GRANDMASTER FLASH & THE FURIOUS FIVE	male
GRANT LEE PHILLIPS	male
Greedies	assume_female
GREEN DAY	male
Greg Kihn	assume_female
GREG KIHN BAND	male
GREG LAKE	male
GREGG ALLMAN	male
GREGORY ABBOTT	male
GREGORY ALAN ISAKOV	male
GREGORY HINES & LUTHER VANDROSS	male
GREYHOUND	male
GRIFF	male
GROVER WASHINGTON JNR	male
Grover Washington Jr. & Bill Withers	assume_female
Gtr	assume_female
GUESS WHO	male
GUILLEMOTS	male
GUN	male
GUNS 'N' ROSES	male
Guns N' Roses	assume_female
GURU JOSH	male
GUY DARRELL	male
GUY MITCHELL	male
GUYS FROM U.N.C.L.E.	male
GWEN GUTHRIE	female
Gwen Guthrie   [partymix]	assume_female
GWEN STEFANI	female
H2O	male
HADDAWAY	male
HAIRCUT 100	male
HALL & OATES	male
Hall And Oates	assume_female
Halloween	assume_female
Halo James	assume_female
HAMILTON JOE FRANK & REYNOLDS	male
HAPPY MONDAYS	male
HARMONY GRASS	male
HAROLD FALTERMEYER	male
HAROLD MELVIN & THE BLUENOTES	male
HARPERS BIZARRE	male
HARPO	male
HARRISON GIBSON	male
HARRY BELAFONTE	male
HARRY CHAPIN	male
Harry Chorale Simeone	male/female
HARRY J ALLSTARS	male
HARRY SECOMBE	male
Harry Simeone Chorale	male/female
HARRY STYLES	male
HARVEY & THE MOONGLOWS	male
HATTIE LITTLES	male
HAWAII	male
HAWKWIND	male
HAYSI FANTAYZEE	female
HAYWOODE	male
HAZEL O'CONNOR	female
HAZELL DEAN	female
HEADLINERS	male
HEALY & AMOS	male
HEART	male/female
HEART OF ICE	male
HEARTBEAT	male
HEATHER NOVA	male
HEATHER SMALL	female
HEATWAVE	male
HEAVEN 17	male
HEDGEHOPPERS ANONYMOUS	male
HEINZ	male
HEINZ & THE WILD BOYS	male
HELEN SHAPIRO	female
HELENE FISCHER	female
HELLO	male
HELLOGOODBYE	male
HENRY MANCINI	male
HEPBURN	male
HERB ALPERT	male
HERBIE GOINS & THE NIGHTIMERS	male
HERBIE HANCOCK	male
HERD	male
HERMAN'S HERMITS	male
HEROES DEL SILENCIO	male
HI-FI'S	male
HIGHWAYMEN	male
HILARY DUFF	female
HILLSIDERS	male
HILLTOPPERS	male
HINTERLAND	male
Hipsway	assume_female
HIT PACK	male
Hoddle And Waddle	assume_female
HOLLIE COOK	female
HOLLIES	male
HOLLY HUMBERSTONE	female
HOLLY JOHNSON	male
HOLLY VALANCE	male
HOLLYWOOD BEYOND	male
HOLYCHILD	male
HOMBRES	male
Home Alone Ii	assume_female
HONEY CONE	male
HONEYBUS	male
HONEYCOMBS	female
HONEYDRIPPERS	male
HONEYZ	male
HOOBASTANK	male
HOOSIERS	male
HOOTERS	male
HOOTIE AND THE BLOWFISH	male
HOPETON LEWIS	male
HORST JANKOWSKI	male
HOT BUTTER	male
HOT CHOCOLATE	male
HOTHOUSE FLOWERS	male
HOUSE OF LOVE	male
HOUSEMARTINS	male
HOWARD CROCKETT	male
HOWARD JONES	male
HUE & CRY	male
Hue And Cry	assume_female
HUES CORPORATION	male
Huey Lewis & The News	assume_female
HUEY LEWIS AND THE NEWS	male
HUGH MALCOLM	male
HUGO MONTENEGRO	male
HULLABALOOS	male
HUMAN EXPRESSION	male
HUMAN LEAGUE	male
HUMBLE PIE	male
HURRICANE SMITH	male
HURTS	male
I AM KLOOT	male
IAN BROWN	male
IAN CAMPBELL FOLK GROUP	male
Ian Dury & The Blockheads	assume_female
IAN DURY AND THE BLOCKHEADS	male
IAN HUNTER	male
ICEHOUSE	male
ICICLE WORKS	male
IDLEWILD	male
IGGY POP	male
IKE AND TINA TURNER	male/female
IKETTES	female
IMAGINATION	male
IMAGINE DRAGONS	male
IMAJIN	male
IMANY	male
IMPERIALS	male
IMPRESSIONS	male
INCANTATION	male
INCOGNITO	male
INDEEP	male
INEZ AND CHARLIE FOXX	male/female
INFORMATION SOCIETY	male
INNER CITY	male
INNOCENCE	male
INNONCENCE MISSION	male
INSPIRAL CARPETS	male
INTRUDERS	male
INXS	male
IPSO FACTO	male
IRENE CARA	female
IRIS WILLIAMS	male
IRON BUTTERFLY	male
Iron Maiden	assume_female
ISAAC HAYES	male
ISIRTA	male
ISLEY BROTHERS	male
IT BITES	male
IT'S A BEAUTIFUL DAY	male
IT'S IMMATERIAL	male
IVY LEAGUE	male
IZZY BIZU	male
J . J. Cale	assume_female
J GEILS BAND	male
J J CALE	male
J MATHIS AND D WILLIAMS	male
J. Geils Band	assume_female
JACK BUCHANAN	male
JACK GARRATT	male
JACK JONES	male
JACK SAVORETTI	male
JACK SCOTT	male
JACKIE DESHANNON	female
JACKIE EDWARDS	female
JACKIE LEE	female
JACKIE LYNTON	female
JACKIE TRENT	female
JACKIE WILSON	female
JACKSON 5	male
JACKSON BROWNE	male
JACKSONS	male
JACOBS ZING	male
JAGS	male
JAGUARS	male
JAKE BUGG	male
JAKI GRAHAM	female
Jaki Graham And David Grant	male/female
JAM	male
JAMES	male
JAMES AND BOBBY PURIFY	male
JAMES BLUNT	male
JAMES BROWN	male
JAMES BROWN AND THE FAMOUS FLAMES	male
JAMES INGRAM AND MICHAEL MCDONALD	male
James Ingram And Patti Austin	assume_female
James Ingram With Michael Mcdonald	male/female
JAMES MORRISON	male
JAMES TAYLOR	male
JAMIE CULLEN	male
JAMIROQUAI	male
JAN AND DEAN	male
JAN HAMMER	male
JAN WAYNE	male
JANE MORGAN	female
JANE WIEDLIN	female
JANE'S ADDICTION	female
JANET JACKSON	female
JANIS IAN	female
JANIS JOPLIN	female
JAPAN	male
JASON DERÜLO	male
JASON DONOVAN	male
JASON MRAZ	male
JAY & THE AMERICANS	male
JAYDEE	male
JAYHAWKS	male
JAZZMASTERS	male
JC STEWART	male
JEANNIE C. RILEY	female
JEANNIE SEELY	female
JEFF BECK	male
JEFF HEALEY	male
JEFFERSON AIRPLANE	male
JEFFERSON STARSHIP	male
JEFFREY OSBORNE	male
JELLYBEAN & ADELE BERTEI	male
JELLYBEAN & ELISA FIORILLO	male
Jellybean And Adele Bertel	assume_female
Jellybean And Elisa Fiorillo	assume_female
Jellybean And Steven Dante	assume_female
JEM	male
JENN	male
JENNIFER LOPEZ	female
JENNIFER PAIGE	female
JENNIFER RUSH	female
JENNIFER WARNES	female
JERMAINE JACKSON	female
JERMAINE JACKSON & PIA ZADORA	male/female
JERMAINE STEWART	male
JERRY BUTLER	male
JERRY BUTLER & THE IMPRESSIONS	male
JERRY JEFF WALKER	male
JERRY KELLER	male
JERRY LEE LEWIS	male
JERRY WALLACE	male
JESS GLYNNE	female
JESSIE WARE	female
JESUS JONES	male
JET HARRIS & TONY MEEHAN	male
JETHRO TOE AKA TULL	male
JETHRO TULL	male
JETS	male
JEWEL AKENS	male
JILL DAY	female
JIM CAPALDI	male
JIM CROCE	male
JIM DALE	male
JIM DIAMOND	male
JIM GILSTRAP	male
JIM PARKER	male
JIM REEVES	male
JIM STAFFORD	male
JIM STEINMAN	male
JIM WHITE	male
JIMI HENDRIX	male
JIMMIE RODGERS	male
JIMMY BUFFETT	male
JIMMY CLANTON	male
JIMMY CLIFF	male
JIMMY HELMS	male
JIMMY HOLIDAY	male
JIMMY JAMES & THE VAGABONDS	male
JIMMY JONES	male
JIMMY JUSTICE	male
JIMMY MCGRIFF	male
JIMMY NAIL	male
JIMMY PARKINSON	male
JIMMY POWELL & THE FIFTH DIMENSION	male
JIMMY RUFFIN	male
JIMMY SMITH	male
JIMMY SOMERVILLE	male
JIMMY SOMERVILLE FEAT. JUNE MILES-KINGSTON	male/female
JIMMY SOUL	male
JIMMY YOUNG	male
JIMOTHY LACOSTE	male
Jingle	assume_female
JJ CALE	male
JLS	male
JO DEE MESSINA	female
JO JO GUNNE	male
JO STAFFORD	female
JOAN ARMATRADING	female
Joan Armtrading	assume_female
JOAN BAEZ	female
Joan Jett	assume_female
JOAN OSBORNE	female
JOAN REGAN	female
JOBOXERS	male
JOCELYN BROWN	female
JODY WATLEY	female
JOE & JAKE	male
JOE BROWN	male
JOE BROWN & THE BRUVVERS	male
JOE COCKER	male
JOE COCKER & JENNIFER WARNES	male
Joe Cocker And Jennifer Warnes	male/female
JOE DOLAN	male
JOE JACKSON	male
JOE LOSS ORCHESTRA	male
JOE MCELDERRY	male
JOE SATRIANI	male
JOE SIMON	male
JOE SMOOTH	male
JOE SOUTH	male
JOE TEX	male
JOE WALSH	male
JOEY GRACEFFA	male
JOEY GRACEFFA & LUKE CONARD	male
JOHN BARRY	male
JOHN BARRY SEVEN PLUS FOUR	male
John Cafferty	assume_female
JOHN COLLIER	male
JOHN COOPER CLARKE	male
JOHN COUGAR	male
John Cougar Mellencamp	assume_female
JOHN DENVER	male
JOHN FARNHAM	male
JOHN FOXX	male
JOHN FRED AND HIS PLAYBOY BAND	male
JOHN LEE HOOKER	male
JOHN LENNON	male
JOHN LENNON AND PLASTIC ONO BAND	male
JOHN LEYTON AND THE LEROYS	male
JOHN MAYALL AND THE BLUESBREAKERS	male
JOHN MELLENCAMP	male
JOHN MILES	male
JOHN PARR	male
JOHN SCHROEDER ORCHESTRA	male
JOHN SEBASTIAN	male
JOHN STEWART	male
JOHN WAITE	male
JOHN WALKER	male
JOHN WEST	male
JOHN WILLIAMS	male
JOHNNIE RAY	male
JOHNNIE WALKER	male
JOHNNY & THE HURRICANES	male
JOHNNY BURNETTE	male
JOHNNY CASH	male
JOHNNY CLEGG & SAVUKA	male
JOHNNY CORPORATE	male
JOHNNY DANKWORTH	male
JOHNNY HATES JAZZ	male
JOHNNY JOHNSON & THE BANDWAGON	male
JOHNNY KIDD & THE PIRATES	male
JOHNNY LOGAN	male
JOHNNY MATHIS	male
JOHNNY MATHIS & DENIECE WILLIAMS	male
JOHNNY NASH	male
JOHNNY OTIS	male
JOHNNY OTIS SHOW	male
JOHNNY PRESTON	male
JOHNNY RIVERS	male
JOHNNY TILLOTSON	male
JOHNNY WAKELIN	male
JOHNNY WINTER	male
JOHNNY YOUNG	male
JOHNNY YOUNG & KOMPANY	male
JON & VANGELIS	male
Jon And Vangelis	assume_female
JON BON JOVI	male
JON SECADA	male
JONA LEWIE	male
JONATHAN BUTLER	male
JONATHAN EDWARDS	male
JONATHAN KING	male
JONATHAN RICHMAN	male
Joni Mitchell	assume_female
JORG ZIMMER	male
JOSE FELICIANO	male
JOSEPH	male
JOSH RITTER	male
JOSH ROUSE	male
JOSHUA KADISON	male
JOSHUA RADIN	male
JOURNEY	male
Joy	assume_female
JOY DIVISION	male
JOYCE SIMS	female
JOYCE'S ANGELS	female
JR. WALKER & THE ALL STARS	male
JUBËL	male
JUDAS PRIEST	male
JUDE COLE	male
JUDGE DREAD	male
JUDIE TZUKE	female
JUDY COLLINS	female
JUDY GARLAND	female
JUDY STREET	female
Judy Tzuke	assume_female
JUICE NEWTON	male
JUICY LUCY	male
JULEE CRUISE	female
JULIA AND COMPANY	female
JULIA FORDHAM	female
JULIAN COPE	male
JULIAN LENNON	male
JULIE DRISCOLL & BRIAN AUGER & THE TRINITY	male/female
JULIE FELIX	female
JULIE GRANT	female
JULIE LONDON	female
JULIE ROGERS	female
JULIET TURNER	female
JUNE CHRISTY	female
JUNIOR	male
JUNIOR JACK	male
JUNIOR SENIOR	male
JUSTIN	male
JUSTIN BIEBER	male
JUSTIN HAYWARD	male
JUSTINE WASHINGTON	male
JUVENTA	male
K D LANG	female
K-CI AND JOJO	male
K.c. & The Sunshine Band	assume_female
KAISER CHIEFS	male
KAJAGOOGOO	male
KALIN TWINS	male
KALITWOOZ	male
KANDI	male
KANE GANG	male
KANSAS	male
KAOMA	male
KAREL FIALKA	male
KAREN RAMIREZ	female
KAREN VERROS	female
KARL DENVER TRIO	male
Karyn White	assume_female
KATE BUSH	female
KATE BUSH & PETER GABRIEL	male/female
KATE ROBBINS	female
KATHY KIRBY	female
KATIE MELUA	female
KATRINA & THE WAVES	female
Katrina And The Waves	assume_female
KATY PERRY	female
KAVANA	male
KAY STARR	male
KC & THE SUNSHINE BAND	male
Kc And The Sunshine Band	assume_female
KEANE	male
KEITH	male
KEITH & TEX	male
KEITH MARSHALL	male
KEITH POWELL & THE VALETS	male
KEITH SWEAT	male
KEITH URBAN	male
KEITH WEST	male
KELE LE ROC	male
Kelly  Marie	assume_female
KELLY MARIE	female
KEN BRUCE	male
KEN DODD	male
KEN THORNE & HIS ORCHESTRA	male
KENDEL CARSON	female
KENI BURKE	male
KENNY	male
KENNY G	male
KENNY LOGGINS	male
KENNY LYNCH	male
KENNY ROGERS	male
Kenny Rogers & Dolly Parton	male/female
KENNY ROGERS & SHEENA EASTON	male/female
KENNY ROGERS & THE FIRST EDITION	male
KETTY LESTER	female
Kfm Xmas Hour Opener	assume_female
KID CREOLE & THE COCONUTS	male
Kid Creole And The Coconuts	assume_female
KIDS FROM FAME	male
KIDS IN GLASS HOUSES	male
KIKI DEE	female
KILLERS	male
KILLING JOKE	male
KIM APPELBY	female
KIM CARNES	female
KIM WESTON	female
KIM WILDE	female
KINCADE	male
KING	male
KING BROTHERS	male
KING CURTIS	male
KINGDOM COME	male
KINGS OF CONVENIENCE	male
KINGS OF LEON	male
KINGS SINGERS	male
KINGSMEN	male
KINGSTON TRIO	male
KINGSTONIANS	male
KINKS	male
KIRSTY MACCOLL	female
KISS	male
KISSING THE PINK	male
KITCHENS OF DISTINCTION	male
KLEERUP	male
KLF	male
Klf (the Timelords)	assume_female
KLF FEAT. THE CHILDREN OF THE REVOLUTION	male
KNACK	male
KNICKERBOCKERS	male
KODALINE	male
KON KAN	male
KOOBAS	male
KOOKS	male
KOOL & THE GANG	male
KOOL AND THE GANG	male
KORGIS	male
KRAFTWERK	male
KRIS KRISTOFFERSON	male
KRISTIAN LEONTIOU	male
KRUSH	male
KT TUNSTALL	female
KUBB	male
KULA SHAKER	male
KURSAAL FLYERS	male
KURTIS BLOW	male
KWS	male
KYLE FALCONER	male
KYLIE MINOGUE	female
Kylie Minogue And Jason Donovan	male/female
KYM MARSH	female
KYM MAZELLE	female
KYM SIMS	female
KYU SAKAMOTO	male
L7	male
LA'S	male
LABI SIFFRE	male
LADY ANTEBELLUM	female
LAID BACK	male
LAKE	male
LALAH HATHAWAY	female
LAMBCHOP	male
LANA SISTERS	female
LANDSCAPE	male
LARRY WILLIAMS	male
LATIN QUARTER	male
LAURA BRANIGAN	female
LAURA NYRO	female
LAURIE JOHNSON ORCHESTRA	male
LAURIE LONDON	male
LAWSON	male
LAYLA KAYLIF	female
LEANN RIMES	female
LEAVES	male
LED ZEPPELIN	male
LEE (SCRATCH) PERRY	male
LEE ANN WOMACK	female
LEE CLAYTON	male
LEE DAVID	male
LEE DORSEY	male
LEE GREENWOOD	male
LEE LAWRENCE	male
LEE MEAD	male
LEE RYAN	male
LEMON PIPERS	male
LEMONHEADS	male
LEN	male
LEN BARRY	male
LENE LOVICH	female
LENE MARLIN	female
LENNY KRAVITZ	male
LENNY WELCH	male
LEO SAYER	male
Leon Haywood	assume_female
LEONIE PERNET	male
LEROY PULLINS	male
LEROY VAN DYKE	male
LES BAXTER	male
LES CRANE	male
LES DAWSON	male
LES PAUL & MARY FORD	male
LESLEY DUNCAN	female
LESLEY GORE	female
LET LOOSE	male
LETTERMEN	male
LEVEL 42	male
LEVELLERS	male
LEVELS	male
LEVERT	male
LEWIS SISTERS	female
LIBERTY X	male
LIEUTENANT PIGEON	male
LIGHT OF THE WORLD	male
LIGHTHOUSE FAMILY	male
LIGHTNING SEEDS	male
Lil Louis And Josh Wink	assume_female
LIMAHL	male
LIMIT	male
LINDA CARR & THE LOVE SQUAD	male/female
LINDA LEWIS	female
LINDA RONSTADT	female
LINDA RONSTADT & JAMES INGRAM	male/female
LINDA RONSTADT FEAT. AARON NEVILLE	male/female
LINDISFARNE	male
LINDSEY BUCKINGHAM	male
LINDSEY BUCKINGHAM & CHRISTINE MCVIE	male/female
LINDY LAYTON	female
LINK CROMWELL	male
LINK WRAY	male
LINK WRAY & HIS RAY MEN	male
LINX	male
LIONEL RICHIE	male
LIPPS INC	male
Liquid Gold	assume_female
Lisa Lisa & Cult Jam	assume_female
LISA LOEB	female
LISA STANSFIELD	female
LISSIE	female
Lita Ford	assume_female
LITTLE ANGELS	male
LITTLE ANTHONY AND THE IMPERIALS	male
LITTLE EVA	female
LITTLE FEAT	male
LITTLE HANK	male
LITTLE JIMMY OSMOND	male
LITTLE LISA	female
LITTLE RICHARD	male
LITTLE RIVER BAND	male
Little Steven	assume_female
LIVERPOOL EXPRESS	male
LIVIN' JOY	male
LIVING COLOUR	male
LIVING IN A BOX	male
LIVING WITH THE ENEMY	male
LIZA MINNELLI	female
LL COOL J	male
Lloyd Cole & The Commotions	assume_female
LLOYD COLE AND THE COMMOTIONS	male
LLOYD PRICE	male
LOBO	male
LOGGINS & MESSINA	male
LOLA LENNOX	female
LONDON GRAMMAR	male
LONDON MODEL ACADEMY	male
Londonbeat	assume_female
LONE JUSTICE	male
LONESTAR	male
LONG HOT SATSUMA	male
LONG JOHN BALDRY	male
LONG TALL ERNIE AND THE SHAKERS	male
LONG VIEW	male
LONNIE DONEGAN	male
LOOK	male
LOOSE ENDS	male
LOOT	male
LORD ROCKINGHAMS XLL	male
LORNE GREEN	male
LORRAINE ELLISON	female
LOS BRAVOS	male
LOS CANARIOS	male
LOS DEL RÍO	male
LOS LOBOS	male
LOTUS EATERS	male
LOU BEGA	male
LOU BUSCH & HIS ORCHESTRA	male
LOU CHRISTIE	male
LOU GRAMM	male
LOU JOHNSON	male
LOU RAWLS	male
LOU REED	male
LOUDON WAINWRIGHT 111	male
LOUIS ARMSTRONG	male
LOUIS ARMSTRONG & THE ALL STARS	male
LOUIS PRIMA & KEELY SMITH	male
LOUISE	female
LOVE	male
LOVE & ROCKETS	male
LOVE AFFAIR	male
Love And Rockets	assume_female
LOVE GENERATION	male
LOVE INC.	male
LOVE SCULPTURE	male
LOVE UNLIMITED	male
LOVERBOY	male
LOVIN' SPOONFUL	male
LOVING AWARENESS	male
LUCIANO PAVAROTTI & PASSENGERS	male
LUCIE SILVAS	female
LUCINDA WILLIAMS	female
LUKE CONARD & JOEY GRACEFFA	male
LULU	female
LUSH	male
LUTHER VANDROSS	male
LUTRICIA MCNEAL	female
LUV	male
LYKKE LI	female
LYNDEN DAVID HALL	male
LYNNE RANDALL	female
LYNSEY DE PAUL	female
LYNYRD SKYNYRD	male
M	male
M PEOPLE	male/female
M.A.R.R.S	male
M/A/R/R/S	male
Mac Band	assume_female
MADHOUSE	male
MADNESS	male
MADONNA	female
MAGIC LANTERNS	male
MAGIC NUMBERS	male
MAGNA CARTA	male
MAGNUM	male
MAI TAI	male
MAIRE BRENNAN	male
Maisonettes	male/female
MALCOLM MCLAREN	male
MALCOLM VAUGHAN	male
Malcom Mclaren	assume_female
MAMA CASS	female
MAMA'S BOYS	male
MAMAS AND THE PAPAS	male/female
MANFRED MANN	male
MANFRED MANN'S EARTHBAND	male
MANHATTANS	male
MANIC STREET PREACHERS	male
MANOWAR	male
MANSUN	male
MANTOVANI AND HIS ORCHESTRA	male
MANTRONIX	male
MAR-KEYS	male
MARBLES	male
MARC ALMOND	male
MARC ALMOND AND GENE PITNEY	male
MARC BOLAN	male
MARC COHN	male
MARCELLA DETROIT	female
MARCELS	male
MARCIA RAVEN	male
MARCIE BLANE	male
MARGARET URLICH	female
MARI WILSON	female
MARIA MCKEE	female
MARIA MULDAUR	female
MARIA VIDAL	female
MARIAH CAREY	female
MARIANNE FAITHFULL	female
MARIE OSMOND	female
MARILLION	male
MARILYN	female
MARINO	male
MARION	male
MARION RYAN	female
MARIONETTES	male
MARK JOSEPH	male
MARK KNOPFLER	male
MARK MORRISON	male
MARK OWEN	male
MARK WYNTER	male
MARMALADE	male
MAROON 5	male
MARSHALL HAIN	male
MARSHALL JEFFERSON	male
MARSHMELLO AND BASTILLE	male
MARSHMELLO AND DEMI LOVATO	male
MARSHMELLO AND JONAS BROTHERS	male
MARSHMELLO AND SELENA GOMEZ	male
MARSHMELLO FT KHALID	male
MARTHA AND THE MUFFINS	male
MARTHA REEVES	female
MARTHA REEVES AND THE VANDELLAS	female
MARTIKA	female
MARTIN GARRIX	male
MARTINE MCCUTCHEON	female
MARTY ROBBINS	male
MARTY WILDE	male
MARV JOHNSON	male
MARV JOHNSTON	male
MARVELETTES	male
MARVIN AND TAMARA	male
Marvin Berry And The Starlighters	assume_female
MARVIN GAYE	male
MARVIN GAYE AND TAMMI TERRELL	male
MARY J BLIGE	female
MARY JANE GIRLS	female
MARY WELLS	female
MASSIVE ATTACK	male
MASTERMINDS	male
MATT BIANCO	male
MATT CARDLE	male
MATT MONRO	male
MATTHEW MARSDEN	male
MATTHEW WILDER	male
MATTHEWS SOUTHERN COMFORT	male
MAUREEN EVANS	female
MAUREEN MCGOVERN	female
MAVERICKS	male
MAX BYGRAVES	male
MAX GEORGE	male
MAX JURY	male
MAXI PRIEST	male
MAYTALS	male
MAZE; FRANKIE BEVERLY	male
MC HAMMER	male
MC MIKER G. & DJ SEVEN	male
MCALMONT & BUTLER	male
MCCOYS	male
Mcfadden & Whitehead	assume_female
MCFADDEN AND WHITEHEAD	male
MCFLY	male
MCFLY & TAIO CRUZ	male
MCGANNS	male
MCGUINNESS FLINT	male
MCGUIRE SISTERS	male
MEAT LOAF	male
MEAT LOAF WITH CHER	male/female
MEDICINE HEAD	male
MEDUSA AFRO	male
MEL & KIM	female
Mel And Kim	assume_female
Mel Brooks	assume_female
MEL TORME	male
MELANIE	female
MELANIE C	female
Melanie Thornton	assume_female
MELBA MOORE	female
MELEE	female
Melissa Manchester	assume_female
MELLOTONES	male
MELODIANS	male
MEN AT WORK	male
MEN WITHOUT HATS	male
MENTAL AS ANYTHING	male
MEREDITH BROOKS	male
MERRILEE RUSH	female
MERSEYBEATS	male
MERSEYS	male
MIAMI SOUND MACHINE	male
MICA PARIS	female
MICA PARIS & WILL DOWNING	male/female
MICHAEL ANDREWS FEAT. GARY JULES	male
MICHAEL BADAL ZYA & TEDDY C	male
MICHAEL BALL	male
MICHAEL BOLTON	male
Michael BublÃ©	assume_female
MICHAEL BUBLE	male
MICHAEL DAVIDSON	male
MICHAEL HOLIDAY	male
MICHAEL HOLLIDAY	male
MICHAEL JACKSON	male
Michael Jackson & Mick Jagger	assume_female
Michael Jackson & Paul Mccartney	assume_female
MICHAEL MCDONALD	male
Michael Mcdonald With Patti Labelle	male/female
MICHAEL PENN	male
Michael Sambello	assume_female
MICHAEL SEMBELLO	male
MICHAEL ZAGER BAND	male
Michelle Shocked	assume_female
Mick Jagger	assume_female
MICK JAGGER & DAVE STEWART	male
MICK JAGGER AND MICHAEL JACKSON	male
MICKEY & SYLVIA	male/female
MIDGE URE	male
MIDNIGHT OIL	male
MIDNIGHT STAR	male
MIGHTY WAH	male
Mighty Wah!	assume_female
MIGIL 5	male
MIKA	male
MIKE AND THE MECHANICS	male
MIKE BERRY	male
MIKE OLDFIELD	male
MIKE PATTO	male
MIKE POST	male
MIKE RABIN AND THE DEMONS	male
MIKE SARNE	male
MILEY CYRUS	female
MILLI VANILLI	male
MILLIE	female
MINDBENDERS	male
MINK DE VILLE	male
MINNIE RIPERTON	female
MIRACLES	male
MISHKA	male
MISSION	male
Mister Mister	assume_female
MITCH RYDER AND THE DETROIT WHEELS	male
MOBY	male
MOCK TURTLES	male
MODERN ROMANCE	male
MODERN TALKING	male
MODEST MOUSE	male
MODJO	male
MOFFATTS	male
MOJOS	male
MOLLY HATCHET	male
MOLOKO	male
MOMENTS	male
MONACO	male
MONITORS	male
MONKEES	male
MONOPOLY	male
MONOTONES	male
MONSOON	male
MONSTERS OF FOLK	male
MONTANAS	male
MOOD MOSAIC	male
MOODY BLUES	male
MOON MARTIN	male
MOONY	male
MORRIS ALBERT	male
MORRISSEY	male
MOSES	male
MOTELS	male
Motley Crue	assume_female
MOTORHEAD	male
MOTORS	male
MOTT THE HOOPLE	male
MOUNTAIN	male
MOVE	male
Moving Pictures	assume_female
MR BIG	male
MR BLOE	male
MR MISTER	male
MR. BIG	male
MR. FINGERS	male
Mtume	assume_female
MUD	male
MUDLARKS	male
MUNGO JERRY	male
MURRAY HEAD	male
MUSE	male
MUSICAL YOUTH	male/female
NAKED EYES	male
NANA MOUSKOURI	female
NANCI GRIFFITH	female
NANCY SINATRA	female
NANCY SINATRA & LEE HAZLEWOOD	male/female
NANCY SINATRA AND LEE HAZLEWOOD	male/female
NANCY WILSON	female
NAPOLEON XIV	male
NARADA MICHAEL WALDEN	male
NASHVILLE TEENS	male
NAT KING COLE	male
NATALIE COLE	female
NATALIE GRANT	female
NATASHA BEDINGFIELD	female
NATURALS	male
NAVY	male
NAZARETH	male
NED MILLER	male
Neil	assume_female
NEIL CHRISTIAN	male
NEIL DIAMOND	male
NEIL FINN	male
NEIL SEDAKA	male
NEIL YOUNG	male
NELLY	female
NELLY FURTADO	male
NENA	female
NENEH CHERRY	female
NEW ATLANTIC	male
NEW EDITION	male
NEW KIDS ON THE BLOCK	male
NEW MODEL ARMY	male
NEW MUSIK	male
NEW ORDER	male
NEW RADICALS	male
NEW RIDERS OF THE PURPLE SAGE	male
NEW SEEKERS FEAT. LYN PAUL	male/female
NEW VAUDEVILLE BAND	male
NEW YORK CITY	male
NEW YORK DOLLS	male
NEW YORK PUBLIC LIBRARY	male
NEWBEATS	male
News in	assume_female
NEWTON FAULKNER	male
NEXT	male
NIALL HORAN	male
NIALL HORAN AND ANNE-MARIE	male/female
NICE	male
Nick Berry	assume_female
NICK HEYWARD	male
NICK KAMEN	male
Nick Lowe	assume_female
NICK STRAKER BAND	male
NICKEL CREEK	male
NICOLE	female
NIGHT RANGER	male
Nik Heyward	assume_female
NIK KERSHAW	male
NILS LOFGREN	male
NILSSON	male
NINA SIMONE	female
NINO TEMPO	male
NINO TEMPO & APRIL STEVENS	male/female
NINO TEMPO AND APRIL STEVENS	male/female
NIRVANA	male
NITTY GRITTY DIRT BAND	male
No Audio In This Category	assume_female
NO DOUBT	male
NO MERCY	male
NOAH AND THE WHALE	male
NOEL GALLAGHER'S HIGH FLYING BIRDS	male
NOLANS	male/female
NOLEN AND CROSSLEY	male/female
NOMAD	male
NORAH JONES	female
NORMA TANEGA	female
NORMALITES	male
NORMAN COOK	male
NORMAN GREENBAUM	male
NORMAN WISDOM	male
NORRIE PARAMOR	male
NOVAS	male
now playing online xmas DRY.mp3	assume_female
NU SHOOZ	male
O'BRIEN BROTHERS	male
O'JAYS	male
O.C. SMITH	male
OASIS	male
OCEAN	male
OCEAN COLOUR SCENE	male
ODIN'S PEOPLE	male
ODYSSEY	male
OH WELL	male
OHIO EXPRESS	male
Oingo Boingo	assume_female
OLD HARRYS GAME	male
OLETA ADAMS	female
OLIVER	male
Oliver Cheatham	assume_female
Olivia Newton John	assume_female
Olivia Newton John / Elo	male/female
Ollie & Jerry	assume_female
OLLIE AND JERRY	male
OLLY MURS	male
OLYMPICS	male
OMC	male
OMD	male
ONE 2 MANY	male
ONE DIRECTION	male
ONE TRUE VOICE	male
ONEREPUBLIC	male
ONLY ONES	male
Only Vip Listeners Dry	assume_female
OPUS	male
OPUS III	male
Oran Juice Jones	assume_female
ORANGE JUICE	male
ORB	male
ORBITAL	male
Orchestral Manoeuvres In The Dark	assume_female
ORDINARY BOYS	male
ORIOLES	male
ORLEANS	male
ORSON	male
OSIBISA	male
OSMONDS	male
OTHER ONES	male
OTIS REDDING	male
OTT	male
OUR DAUGHTERS WEDDING	male
Outfield	assume_female
OUTKAST	male
OUTLAWS	male
OVERLANDERS	male
OWEN PAUL	male
OWL CITY	male
OXFORD CIRCLE	male
Ozzy Osbourne & Lita Ford	male/female
Ozzy Ozborne	assume_female
Ozzy Ozbourne	assume_female
P J PROBY	male
P P ARNOLD	female
P!NK	male
PAGEBOYS	male
PANTERA	male
PAOLO NUTINI	male
PAPER DOLLS	male
PARAGONS	male
PARAMOUNTS	male
PASADENAS	male
PASSIONS	male
PAT BENATAR	female
PAT BOONE	male
PATO BANTON FEAT. ALI AND ROBIN CAMPBELL	male
PATRICE RUSHEN	female
PATRICK COWLEY FEAT. SYLVESTER	male
Patrick Swayze	assume_female
PATRICK WATSON	male
PATRIZIO BUANNE	male
PATSY CLINE	female
PATTI AUSTIN & JAMES INGRAM	male/female
PATTI LABELLE	female
PATTI LABELLE & MICHAEL MCDONALD	male/female
PATTI SMITH GROUP	female
Pattie Labelle With Michael Mcdonald	male/female
PATTY SMYTH	female
PAUL AND BARRY RYAN	male
PAUL AND PAULA	male/female
PAUL AND RITCHIE AND THE CRYING SHAMES	male/female
PAUL ANKA	male
PAUL BRADY	male
PAUL BUTTERFIELD BLUES BAND	male
PAUL CARRACK	male
PAUL DAVIS	male
PAUL EVANS AND THE CURLS	male
PAUL HARDCASTLE	male
PAUL JONES	male
PAUL MCCARTNEY	male
PAUL MCCARTNEY AND MICHAEL JACKSON	male
PAUL MCCARTNEY AND STEVIE WONDER	male
PAUL MCCARTNEY AND WINGS	male
PAUL NORTON	male
PAUL PETERSEN	male
PAUL REVERE AND THE RAIDERS	male
PAUL SIMON	male
PAUL VAN DYK	male
PAUL WELLER	male
PAUL YOUNG	male
PAULA ABDUL	female
PAULA COLE	female
PAULINE BLACK OF THE SELECTOR	female
PAULINE HENRY	female
PEABO BRYSON & ROBERTA FLACK	male
PEACHES AND HERB	male
PEBBLES	female
PEGGY LEE	female
PENGUINS	male
PEPSI AND SHIRLIE	female
PERCY FAITH	male
PERCY SLEDGE	male
PEREZ PRADO	male
PEREZ PRADO FEAT. ROSEMARY CLOONEY	male/female
PERRY COMO	male
PERSONNA	male
PET SHOP BOYS	male
PET SHOP BOYS AND EIGHTH WONDER	male
PETE BEST FOUR	male
PETE SEEGER	male
Pete Townsend	assume_female
PETE TOWNSHEND	male
PETE WYLIE	male
PETER AND GORDON	male
PETER ANDRE	male
PETER BRUNTNELL	male
PETER CETERA	male
Peter Cetera & Amy Grant	male/female
PETER FRAMPTON	male
PETER GABRIEL	male
Peter Gabriel Kate Bush	male/female
PETER GREEN	male
PETER LEE STIRLING	male
PETER PAUL & MARY	male/female
PETER SARSTEDT	male
PETER SCHILLING	male
PETER TOSH	male
PETERS AND LEE	male/female
PETTICOAT	female
PETULA CLARK	female
PHATS & SMALL	male
PHATS AND SMALL	male
PHD	male
PHIL CARMEN	male
PHIL COLLINS	male
PHIL FEARON & GALAXY	male
Phil Fearon And Galaxy	male/female
PHIL PHILLIPS	male
PHIL PHILLIPS AND THE TWILIGHTS	male
PHIL SPECTOR	male
PHIL UPCHURCH COMBO	male
PHILIP BAILEY	male
PHILLIP LYNOTT	male
PHIXX	male
PHYLLIS NELSON	female
PIANOMAN	male
PICKETTYWITCH	male/female
PIGLETS	male
Pil (public Image Limited)	assume_female
PILOT	male
PINK	male
PINK FLOYD	male
PINKEES	male
PINKERTON'S ASSORTED COLOURS	male
PINKERTON'S COLOURS	male
PINKERTONS ASSORTED COLOURS	male
PIONEERS	male
PIPKINS	male
PIPS	assume_female
Piranhas	assume_female
PIZZAMAN	male
PJ PROBY	male
PLAIN WHITE T'S	male
PLANET FUNK	male
PLANET PERFECTO FEAT. GRACE	male
PLASTIC BERTRAND	male
PLATTERS	male
PLAYER	male
PLUMB	male
PM DAWN	male
POCO	male
POETS	male
POETS (US)	male
POGUES & KIRSTY MACCOLL	male/female
Pogues And Kirsty Maccoll	male/female
POINT BREAK	male
POINTER SISTERS	female
POISON	male
POLARKREIS 18	male
POLICE	male
PONI TAILS	female
PONI-TAILS	female
PONY	male
POP WILL EAT ITSELF	male
POWER STATION	male
POWERHOUSE FEAT. DUANE HARDEN	male
Powerstation	assume_female
PRECIOUS	male
PREFAB SPROUT	male
PRELUDE	male
PRESENT FAIRY commericalgen.mp3	assume_female
PRETENDERS	male
Pretty Poison	assume_female
PRETTY THINGS	male
PRIMAL SCREAM	male
PRIMITIVES	male
PRINCE	male
Princess	assume_female
PROCLAIMERS	male
PROCOL HARUM	male
PRODIGY	male
PROPAGANDA	male
PSEUDO ECHO	male
PSYCHEDELIC FURS	male
PUBLIC IMAGE LTD	male
PUFF DADDY	male
PULP	male
PUPPINI SISTERS	female
Pure Prairie League	assume_female
PURPLE GANG	male
PYTHON LEE JACKSON	male
QUARTERFLASH	male
QUARTZ & DINA CARROLL	male/female
QUEEN	male
QUEEN & DAVID BOWIE	male
QUESTION MARK AND THE MYSTERIANS	male
QUICKSILVER MESSENGER SERVICE	male
QUIET RIOT	male
QUINCY JONES	male
QUIREBOYS	male
R DEAN TAYLOR	male
R KELLY	male
R. B. GREAVES	male
R.B.A.	male
R.E.M	male
RACEY	male
RACHEL STEVENS	female
RACING CARS	male
RADIOHEAD	male
RAGE	male
RAH BAND	male
RAILWAY CHILDREN	male
RAINBOW	male
RAINMAKERS	male
RAINY DAZE	male
RALPH MCTELL	male
RALPH TRESVANT	male
RAM JAM	male
RAMONES	male
RANDY CRAWFORD	female
RANDY EDELMAN	male
RANDY NEWMAN	male
RANDY VANWARMER	male
RANG-A-TANG UNCOVERED	male
RARE BIRD	male
RASCALS	male
RATT	male
RAY ANTHONY	male
RAY CHARLES	male
RAY ELLINGTON QUARTET	male
RAY LAMONTAGNE	male
RAY MARTIN	male
RAY MOORE	male
Ray Parker Jnr	assume_female
RAY PARKER JR	male
Ray Parker Jr.	assume_female
RAY PETERSON	male
RAY RUFF & THE CHECKMATES	male
RAY SHARPE	male
RAY STEVENS	male
RAYDIO	male
RAZE	male
RAZORLIGHT	male
RE-FLEX	male
REAL THING	male
RED BOX	male
RED HOT CHILI PEPPERS	male
Redbone	assume_female
REDCAPS	male
REEF	male
REINDEER SECTION	male
REM	male
REMBRANDTS	male
RENAISSANCE	male
RENE AND ANGELA	male/female
RENEE AND RENATO	male/female
REO SPEEDWAGON	male
REPARATA & THE DELRONS	female
REPUBLICA	male
REVELATIONS	male
REX GARVIN	male
RIC OCASEK	male
RICHARD ANTHONY	male
RICHARD ASHCROFT	male
RICHARD DURAND	male
RICHARD HAWLEY	male
RICHARD HUDNUT	male
RICHARD JON SMITH	male
RICHARD MARX	male
RICHE	male
RICHIE BARRETT	male
RICK ASTLEY	male
RICK JAMES	male
RICK JAMES & TEENA MARIE	male/female
RICK NELSON	male
RICK SPRINGFIELD	male
RICKIE LEE JONES	male
RICKY DILLON	male
Ricky Lee Jones	assume_female
RICKY MARTIN	male
RICKY NELSON	male
RICKY VALANCE	male
RIGHEIRA	male
RIGHT SAID FRED	male
RIGHTEOUS BROTHERS	male
Rihanna	assume_female
RITA COOLIDGE	female
RITA PAVONE	female
RITCHIE VALENS	male
RITON & OLIVER HELDENS	male
RIVER CITY PEOPLE	male
ROACHFORD	male
ROARING SIXTIES	male
ROBBIE NEVIL	male
ROBBIE ROBERTSON	male
ROBBIE WILLIAMS	male
ROBERT HOWARD & KYM MAZELLE	male/female
Robert Howard / Kym Mazelle	male/female
ROBERT JOHN	male
ROBERT KNIGHT	male
ROBERT MILES. FEAT MARIA NAYLOR	male/female
ROBERT PALMER	male
ROBERT PARKER	male
ROBERT PLANT	male
ROBERT PLANT & ALISON KRAUSS	male/female
ROBERT POST	male
ROBERTA FLACK & PEABO BRYSON	male/female
ROBERTA FLACK AND DONNY HATHAWAY	male/female
ROBIN BECK	male
ROBIN GIBB	male
ROBIN TROWER	male
ROBYN	female
ROCK STEADY CREW	male
ROCKERS REVENGE	male
ROCKERS REVENGE FT. DONNIE CA	male
ROCKIN' BERRIES	male
ROCKIN' VICKERS	male
ROCKWELL	male
ROCKY BURNETTE	male
Rocky Horror Picture Show	male/female
Rocky Soundtrack	assume_female
ROCOCO	male
ROD STEWART	male
ROD STEWART AND RONAL ISLEY	male
Rod Stewart And Ronald Isely	assume_female
ROD STEWART AND THE FACES	male
ROGER DALTREY	male
ROGER MILLER	male
ROGER ROYLE	male
ROGER SANCHEZ	male
ROGER WHITTAKER	male
ROLF HARRIS	male
ROLLING STONES	male
Roman Holliday	assume_female
ROMANTICS	male
ROMEO	male
ROMEO & THE EMOTIONS	male
RON GRAINER	male
RONAN KEATING	male
RONAN KEATING & LEANN RIMES	male/female
RONETTES	female
RONNIE HILTON	male
ROOFTOP SINGERS	male
ROOM 5 FEAT. OLIVER CHEATHAM	male
ROOSTERS	male
RORY GALLAGHER	male
ROSANNE CASH	female
ROSE ROYCE	female
ROSEMARY CLOONEY	female
Rosie Vela	assume_female
ROSS HANNAMAN	male
ROTARY CONNECTION	male
ROTHCHILDS	male
ROUEN	male
ROULETTES	male
ROXETTE	male/female
ROXY MUSIC	male
ROY HEAD	male
ROY ORBISON	male
ROY SHIRLEY	male
ROY WOOD AND WIZZARD	male
Royal Philharmonic Orchestra	assume_female
ROYKSOPP	male
ROZALLA	female
RUBETTES	male
RUBY & THE ROMANTICS	female
RUBY AND THE ROMANTICS	female
RUBY MURRAY	female
RUBY TURNER	female
RUDY MILLS	female
RUFF DRIVERZ PRESENTS ARROLA	male
RUFUS AND CHAKA KHAN	male/female
RUFUS THOMAS	male
RUI DA SILVA	male
RUN DMC	male
Run Dmc And Aerosmith	assume_female
RUN DMC VS JASON NEVINS	male
RUN DMC WITH AEROSMITH	male
RUNAWAY	male
RUNRIG	male
RUPERT HOLMES	male
RUSH	male
RUSS BALLARD	male
RUSS CONWAY	male
RUSS HAMILTON	male
RUTH BROWN	female
RY COODER	male
RYAN ADAMS	male
RYAN PARIS	male
RYANDAN	male
RYCOL	male
S CLUB 7	male
S'EXPRESS	male
S.O.S BAND	male
SABRINA	female
SACRED SPIRIT	male
SAD CAFE	male
SADE	female
SAFRI DUO	male
SAGA	male
SAILCAT	male
SAILOR	male
SAINT ETIENNE	male
SALENA JONES	male
SALLY OLDFIELD	female
SALT-N-PEPA	female
SAM AND DAVE	male
SAM AND MARK	male
SAM BROWN	female
SAM COOKE	male
SAM FENDER	male
SAM THE SHAM AND THE PHAROAHS	male
SAMANTHA FOX	female
SAMANTHA MUMBA	female
SAMMY DAVIS JR	male
SAN & WENDEL KOS	male
SAN REMO GOLDEN STRINGS	male
SANDI SHELDON	female
SANDIE SHAW	female
SANDPIPERS	male
SANDRA	female
SANDY B	male
SANDY POSEY	female
SANTA ESMERALDA	male
SANTANA	male
SARAH BRIGHTMAN	female
SARAH K	female
SARAH MCLACHLAN	female
SARAH'S CAROL SINGER	female
SASH	female
SASHA & EMERSON	female
SATURDAYS	male
SATURDAYS & FLO RIDA	male
SAVAGE GARDEN	male
SAXON	male
SAY LOU LOU	male
SCAFFOLD	male
SCARLET	male
SCARLET FANTASTIC	male
SCENT	male
SCISSOR SISTERS	female
SCORPIONS	male
SCOTT & LEON	male
SCOTT FITZGERALD & YVONNE KEELEY	male/female
SCOTT MCKENZIE	male
SCOTT WALKER	male
SCOUTING FOR GIRLS	male
SCREAMING TREES	male
SCRIPT	male
SCRITTI POLITTI	male
SEA WOLF	male
SEAL	male
SEALS & CROFTS	male
SEARCHERS	male
SEEDS	male
SEEKERS	male/female
SELECTER	male
SENSATIONS	male
SERGIO MENDES	male
SETTLERS	male
SEVENTHAVENUE	male
Sexpress	assume_female
SHADOWS	male
SHADOWS OF KNIGHT	male
SHAGGY	male
SHAKATAK	male
SHAKATAK & AL JARREAU	male
Shakatak with Al Jarreau	male/female
SHAKESPEAR'S SISTER	female
Shakin Stevens	assume_female
SHAKIN' STEVENS	male
SHAKIRA	female
SHALAMAR	male
SHAMEN	male
SHANE FENTON & THE FENTONES	male
SHANGRI-LAS	female
SHANIA TWAIN	female
SHANICE	female
SHANKS & BIGFOOT	male
SHANNON	male
SHAPESHIFTERS	male
SHARI BELAFONTE	male
SHARLEEN SPITERI	female
SHARON CORR	female
Sharon Redd	assume_female
SHARPE & NUMAN	male
Sharpe And Numan	assume_female
SHAWN COLVIN	female
SHAWN MULLINS	male
SHAYNE WARD	male
SHE TRINITY	female
SHED SEVEN	male
SHEENA EASTON	female
SHEILA B DEVOTION	female
SHEILA E.	female
SHELBY FLINT	male
SHEPPARD	male
SHERBET	male
Sheriff	assume_female
SHERRICK	male
SHERYL CROW	female
SHILHOUETTES	male
SHIRELLES	female
SHIRES	male
SHIRLEY & COMPANY	female
SHIRLEY BASSEY	female
SHIRLEY ELLIS	female
SHOCKING BLUE	male
SHOLA AMA	female
SHOTGUN EXPRESS	male
SHOWADDYWADDY	male
SHOWMEN	male
SHOWSTOPPERS	male
Sidney Youngblood	assume_female
SIGALA & JAMES ARTHUR	male
SIGHT AND SOUND	male
SIGMA	male
SIGMA AND JACK SAVORETTI	male
SIGNS	male
SIGUE SIGUE SPUTNIK	male
SILENCE	male
SILKIE	male
SIMON AND GARFUNKEL	male
SIMON DUPREE AND THE BIG SOUND	male
SIMON PARK ORCHESTRA	male
SIMON SISTERS	female
SIMON WEBBE	male
SIMPLE KID	male
SIMPLE MINDS	male
SIMPLY RED	male
SINÉAD O'CONNOR	female
SINEAD LOHAN	female
Sinead O' Connor	assume_female
SINEAD O'CONNOR	female
Sinitta	assume_female
SIOUXSIE & THE BANSHEES	female
SIOUXSIE AND THE BANSHEES	female
SIR DOUGLAS QUINTET	male
SIR TERRY WOGAN	male
SISTER SLEDGE	female
SISTERS OF MERCY	female
SIXPENCE NONE THE RICHER	male
SKATALITES	male
SKEETER DAVIS	female
SKID ROW	male
SKIDS	male
SKIVERS	male
SKY ISLAND	male
SL2	male
SLADE	male
SLEEPER	male
SLIK	male
SLIM WHITMAN	male
SLY	male
SLY AND THE FAMILY STONE	male
SLY FOX	male
SMALL FACES	male
SMARTIES	male
SMITHS	male
SMOKE	male
SMOKEY ROBINSON	male
SMOKEY ROBINSON AND THE MIRACLES	male
SMOKIE	male
SNAP	male
SNIFF 'N' THE TEARS	male
Sniff And The Tears	assume_female
SNOW PATROL	male
SNOWBALL	male
SNOWY WHITE	male
SODA CLUB	male
SOFT CELL	male
SOLOMON BURKE	male
Sonia	assume_female
SONICS	male
SONJA	female
SONNY AND CHER	male/female
SONS OF FRED	male
SOPHIE B HAWKINS	female
SOPHIE ELLIS BEXTOR	female
SORROWS	male
Sos Band	assume_female
SOUL ASYLUM	male
Soul I I  Soul	male/female
Soul I I Soul Feat. Caron Wheeler	assume_female
SOUL II SOUL	male
Soul Ii Soul Feat. Caron Wheeler	assume_female
SOUNDGARDEN	male
SOUNDS ORCHESTRAL	male
SOUP DRAGONS	male
SOURCE	male
SOURCE FEAT. CANDI STATON	male/female
SOUTHSIDE JOHNNY AND THE ASBURY JUKES	male
SPACE	male
SPACE COWBOY	male
SPADES	male
SPAGNA	male
SPANDAU BALLET	male
SPANKY AND OUR GANG	male
SPARKS	male
SPC	male
SPEAR OF DESTINY	male
SPECIAL AKA	male
SPECIALS	male
SPECTRES	male
SPENCER DAVIS GROUP	male
SPICE GIRLS	female
SPILLER	male
SPIN DOCTORS	male
SPINNERS	male
SPIRIT	male
SPIRITUALIZED	male
SPLIT ENZ	male
SPOKESMEN	male
SPRINGERS	male
SPRINGFIELDS	male
SQUEEZE	male
STACIE ORRICO	female
STAIND	male
STAN FREBERG	male
STAN MEISSNER	male
Stan Ridgway	assume_female
STANDS	male
STANLEY HOLLOWAY	male
STAPLE SINGERS	male
STARBUCK	male
Stars On 45	male/female
STARSHIP	male
STATE OF THE HEART	male
STATUS QUO	male
STEALERS WHEEL	male
STEAM	male
STEELEYE SPAN	male
STEELY DAN	male
STEINER	male
STEPHANIE MILLS	female
STEPHEN 'TIN TIN' DUFFY	male
STEPHEN FRETWELL	male
STEPHEN STILLS	male
Stephen Tin Tin Duffy	assume_female
STEPPENWOLF	male
STEPS	male
STEREO MC'S	male
STEREO MCS	male
STEREOPHONICS	male
STEVE ARRINGTON	male
STEVE BALSAMO	male
Steve Dry	assume_female
STEVE EARLE	male
STEVE FORBERT	male
STEVE HARLEY & COCKNEY REBEL	male
STEVE MILLER BAND	male
STEVE PERRY	male
Steve V/o	assume_female
STEVE WINWOOD	male
STEVIE B	male
STEVIE NICKS	female
Stevie Nicks And Tom Petty	male/female
STEVIE WONDER	male
Stevie Wonder With Paul Mccartney	assume_female
STILL CORNERS	male
STILTSKIN	male
STING	male
Stock/aitken/waterman	male/female
STONE PONEYS	male
STONE ROSES	male
STOOGES	male
STRANGELOVES	male
STRANGER & GLADDY	male
STRANGLERS	male
STRAWBERRY ALARM CLOCK	male
STRAWBERRY SWITCHBLADE	male
STRAWBS	male
STRAY CATS	male
StreamTheNet	assume_female
STRETCH 'N' VERN	male
STRIKE	male
STROKES	male
STYLE COUNCIL	male
STYLISTICS	male
STYX	male
SUE NICHOLLS	female
SUE THOMPSON	female
SUEDE	male
SUGABABES	female
SUGAR MINOTT	male
SUGAR RAY	male
SUGARHILL GANG	male
SUN DRAGON	male
SUNDAYS	male
SUNSCREEM	male
SUNSHINE COMPANY	male
SUPER FURRY ANIMALS	male
SUPERGRASS	male
SUPERTRAMP	male
Support Drop + Request	assume_female
SUPREMES	female
SUREFIRE	male
SURFARIS	male
SURFERS	male
SURVIVOR	male
SUSAN CHRISTIE	female
SUSAN FASSBENDER	female
SUSAN MAUGHAN	female
SUSAN RAYE	female
Susanna Hoffs	assume_female
SUTHERLAND BROTHERS & QUIVER	male
SUZANNE VEGA	female
SUZI QUATRO	female
Suzi Quatro With Chris Norman	male/female
SUZY & THE RED STRIPES	female
SWANSWAY	male
SWEDISH HOUSE MAFIA	male
SWEET	male
SWEET INSPIRATIONS	male
SWEET SENSATION	male
SWIMMING WITH SHARKS	male
SWING OUT SISTER	female
SWINGING BLUE JEANS	male
SYD MATTERS	male
SYDNEY YOUNGBLOOD	male
SYLVIA	female
SYNDICATE OF SOUND	male
SYSTEM	male
T'PAU	male
T.O.M.	male
T.REX	male
TAB HUNTER	male
TACKLE	male
Taco	assume_female
TAIO CRUZ	male
TAIO CRUZ & KE$HA	male
TAIO CRUZ & LUCIANA CAPORASO	male
TAIO CRUZ & LUDACRIS	male
TAIO CRUZ & TINCHY STRYDER	male
TAJA SEVELLE	female
TAKE THAT	male
TALK TALK	male
TALKING HEADS	male
TAMI LYNN	female
TAMMI TERRELL	female
TAMMY WYNETTE	female
TAMS	male
Tanita Tikaram	assume_female
TASMIN ARCHER	female
TATU	male
TAVARES	male
TAWNY REED	male
TAXI	male
TAYLOR DAYNE	female
TAYLOR SWIFT	female
TEACH IN	male
TEARDROP EXPLODES	male
TEARS FOR FEARS	male
TECHNOTRONIC FEAT. NELLY	male
TED NUGENT	male
TEDDY BEARS	male
TEDDY JOHNSON & PEARL CARR	male/female
TEDDY THOMPSON	male
TEE SET	male
TEENA MARIE	female
TEENAGE FANCLUB	male
TEENAGERS	male
TEMPERANCE SEVEN	male
TEMPTATIONS	male
TEMPTATIONS FEAT. RICK JAMES	male
TEN YEARS AFTER	male
TENNESSEE ERNIE FORD	male
TENNORS	male
Tenpole Tudor	assume_female
TERENCE TRENT D'ARBY	male
TERESA BREWER	female
Terrence Trent D'arby	assume_female
TERRI WELLS	female
TERRORVISION	male
TERRY DENE	male
TERRY JACKS	male
TERRY MAXX	male
TERRY REID	male
TERRY STAFFORD	male
TEXAS	male/female
TEXAS & WU-TANG CLAN	male/female
THANE RUSSELL & THREE	male
The Carpenters	male/female
The Jets	assume_female
THE NOLANS	assume_female
The Tubes	assume_female
The Waitresses	assume_female
THEM	male
Theme	assume_female
THEN JERICHO	male
Then Jerico	assume_female
THEY MIGHT BE GIANTS	male
THIN LIZZY	male
THIRD WORLD	male
THIRTEEN SENSES	male
THIRTEENTH FLOOR ELEVATORS	male
this is a kfm xmas specialDRY.mp3	assume_female
THOMAS DOLBY	male
THOMPSON TWINS	male
THORNS	male
THREE AMIGOS	male
THREE DEGREES	female
THREE DOG NIGHT	male
THREE O'CLOCK	male
THRILLS	male
THUNDER	male
THUNDERBIRDS ARE GO	male
THUNDERCLAP NEWMAN	male
TIFFANY	female
TIFT MERRITT	female
TIGHT FIT	male/female
Til Tuesday	assume_female
TIM BUCKLEY	male
TIM HARDIN	male
TIM ROSE	male
TIM VINE	male
TIMBALAND	male
Timbuk 3	assume_female
TIME	male
TIMEBOX	male
Timex Social Club	assume_female
TIMI YURO	male
TIMMY THOMAS	male
TIN TIN OUT	male
TINA ARENA	female
TINA BRITT	female
TINA COUSINS	female
TINA TURNER	female
TINY DANCERS	female
TOBY LIGHTMAN	male
TODD RUNDGREN	male
TODD TERRY	male
TOM BAXTER	male
TOM CLOUD	male
TOM COCHRANE & RED RIDER	male
Tom Johnston	assume_female
TOM JONES	male
TOM JONES & CERYS MATTHEWS	male
TOM ODELL	male
TOM PETTY	male
TOM ROBINSON	male
TOM RUSH	male
TOM SPEIGHT	male
TOM THUMB CIGARS	male
TOM TOM CLUB	male
TOMMY BOYCE	male
TOMMY BRUCE	male
TOMMY DORSEY	male
TOMMY EDWARDS	male
TOMMY JAMES AND THE SHONDELLS	male
TOMMY QUICKLY & THE REMO FOUR	male
TOMMY ROE	male
TOMMY SPARKS	male
TOMMY STEELE	male
TOMMY TUCKER	male
Tommy Tutone	assume_female
Tone Loc	assume_female
TONI BASIL	female
TONI BRAXTON	female
TONI BRAXTON & KENNY GEE	male/female
TONY BENNETT	male
TONY BRENT	male
TONY HATCH ORCHESTRA	male
TONY JACKSON & THE VIBRATIONS	male
TONY JACKSON WITH THE VIBRATIONS	male
TONY JOE WHITE	male
TONY MARTIN	male
TONY RIVERS & THE CASTAWAYS	male
TOPLOADER	male
TORI AMOS	female
TORNADOS	male
Total Contrast	assume_female
TOTO	male
TOTO COELO	male
Tourists	male/female
TOYAH	female
TOYS	male
TQ	male
TRACEY ULLMAN	female
TRACY CHAPMAN	female
TRACY ULLMAN	female
TRADEWINDS	male
TRAFFIC	male
TRAFFIC JAM	male
TRAIN	male
TRAITS	male
TRAMMPS	male
TRANSVISION VAMP	male
TRASHMEN	male
TRAVELING WILBURYS	male
Travelling Wilburys	assume_female
TRAVIS	male
TREMELOES	male
TRENDS	male
TREVOR WALTERS	male
TRINI LOPEZ	male
TRIO	male
TROGGS	male
TROYE SIVAN	male
TROYE SIVAN AND KACEY MUSGRAVES	male/female
TRUESTEPPERS FEAT. BRIAN HARVEY	male
TRULY SMITH	female
TRUTH	male
TUBES	male
TUBEWAY ARMY	male
TUDOR QUEEN	male
TURIN BRAKES	male
TURTLES	male
TUSSE	female
TWEENIES	male
TWENTY 4 SEVEN	male
TWICE AS MUCH	male
TWINKLE	female
TWISTED SISTER	male
TYMES	male
TYPICALLY TROPICAL	male
U.S.U.R.A.	male
U2	male
U2 FEAT. BB KING	male/female
Ub 40	assume_female
Ub 40 And Chrissie Hynde	male/female
UB 40 AND ROBERT PALMER	male
UB40	male
UFO	male
UGLY KID JOE	male
UGLYS	male
UK SUBS	male
ULTRA	male
ULTRA NATE	male
ULTRABEAT	male
ULTRAVOX	male
UNDERCOVER	male
UNDERTAKERS	male
UNDERTONES	male
UNDERWORLD	male
UNIQUES	male
UNIT 4+2	male
UPPER ROOM	male
URIAH HEEP	male
UTAH SAINTS	male
VAL BENNETT	male
VAL DOONICAN	male
VALERIE MITCHELL	female
VAMPS	male
VAMPS & MATOMA	male
VAN HALEN	male
VAN MORRISON	male
VANESSA AMOROSI	female
VANESSA CARLTON	female
VANESSA PARADIS	female
VANESSA WILLIAMS	female
VANGELIS	male
VANILLA FUDGE	male
VANILLA ICE	male
VANITY FARE	male
VAPORS	male
VASCONCELOS	male
VASHTI	male
VEJTABLES	male/female
VELVELETTES	female
VELVET UNDERGROUND	male
VELVET UNDERGROUND AND NICO	male
VENACCIO & DAIGON	male
VENGABOYS	male
VENTURES	male
VERACOCHA	male
VERDELLE SMITH	female
VERNONS GIRLS	female
VERVE	male
VESSELS	male
VESTA WILLIAMS	female
VIC DAMONE	male
VIKKI CARR	female
Village People	assume_female
VIPERS SKIFFLE GROUP	male
VISAGE	male
VIXEN	female
VOGUES	male
VOICE OF THE BEEHIVE	female
VOWS	male
WACKERS	male
WAITRESSES	male/female
WALK THE MOON	male
WALKER BROTHERS	male
WALLS	male
WANDA JACKSON	female
WANG CHUNG	male
WANNADIES	male
WANTED	male
WARM SOUNDS	male
WARP BROS VS AQUAGEN	male
WARRANT	male
WARREN ZEVON	male
WAS (NOT WAS)	male
Was Not Was	assume_female
WATERBOYS	male
WATERFRONT	male
WAVELENGTH	male
WAX	male
WAY OUT WEST	male
WAYNE FONTANA	male
WE FIVE	male
WE THE PEOPLE	male
WEATHER GIRLS	female
WEAVERS	male
WEBB SISTERS	female
WEEKEND	male
WEEKND	male
Well Well Well	assume_female
WENDY MOTEN	female
WESTLIFE	male
Westworld	male/female
WET WET WET	male
Wham	assume_female
WHAM!	male
WHEEL-A-WAYS	male
When In Rome	assume_female
WHISPERS	male
WHISTLING JACK SMITH	male
WHITE AND TORCH	male
WHITE LION	male
WHITE PLAINS	male
WHITE TOWN	male
WHITESNAKE	male
WHITNEY HOUSTON	female
WHO	male
WILD CHERRY	male
WILDCHILD	male
WILDHEARTS	male
WILL DOWNING	male
WILL POWERS	female
WILL TO POWER	female
WILL YOUNG	male
WILLIAM BELL	male
WILLIE HUTCH	male
WILLIE MITCHELL	male
WILLIE NELSON	male
WILLIE NELSON AND LEE ANN WOMACK	male/female
WILSON PHILLIPS	female
WILSON PICKETT	male
WINDJAMMER	male
WINGS	male/female
WIRE DAISIES	male
WISHBONE ASH	male
WIZ KHALIFA	male
WIZZARD	male
WOGAN WALTERS MARSH	male
WOLF ALICE	male/female
WOLFMAN FEAT. PETER DOHERTY	male
Womack & Womack	male/female
WOMACK AND WOMACK	male/female
WONDERLAND	male
WOOKIE FEAT. LAIN	male
WORLD PARTY	male
WYCLEF JEAN	male
X AMBASSADORS	male
xmas rock and popDRY.mp3	assume_female
Xmas-southpark	assume_female
XPANSIONS	male
XPRESS 2	male
XTC	male
YARBROUGH AND PEOPLES	male
YARDBIRDS	male
YAZOO	male/female
YAZZ	female
YAZZ AND THE PLASTIC POPULATION	male/female
YEARS AND YEARS	male
YEARS AND YEARS AND KYLIE MINOGUE	male/female
YELL	male
YELLO	male
YELLOW DOG	male
YES	male
YOMANDA	male
YORK	male
YOUNG IDEA	male
YOUNG RASCALS	male
YOUNGBLOODS	male
YVONNE ELLIMAN	female
YY28'S	male
ZAGER AND EVANS	male
ZIGGY MARLEY	male
ZINC DJ	male
ZING	male
ZOE MAZAH	female
ZOMBIE NATION	male
ZOMBIES	male
ZOO BRAZIL	male
ZOOT MONEY'S BIG ROLL BAND	male
ZUCCHERO	male
ZZ TOP	male
