'TIL TUESDAY	M
10CC	M
13TH FLOOR ELEVATORS	M
16 TAMBOURINES	M
1910 FRUITGUM COMPANY	M
1975 (THE)	M
2 UNLIMITED	M
2AM	M
3 AMIGOS	M
3 JAYS	M
38 SPECIAL	M
4 NON BLONDES	M
5 STAR	M/F
5TH DIMENSION	M
808 STATE	M
911	M
A CERTAIN RATIO	M
A FLOCK OF SEAGULLS	M
A TASTE OF HONEY	M/F
A VERY GOOD FRIEND FEAT. JOY	M
A-HA	M
A1	M
AALIYAH	M
AARON NEVILLE	M
ABBA	M/F
ABC	M
ACE	M
ACE OF BASE	M
ACKER BILK	M
AD BROWN AND MATT LANGE	M
AD LIBS	M/F
ADAM AND THE ANTS	M
ADAM ANT	M
ADAM FAITH	M
ADAM RICKITT	M
ADAM SNYDER	M
ADAMSKI	M
ADEVA	F
ADIEMUS	M
ADRIAN GURVITZ	M
ADVENTURES	M
ADVENTURES OF STEVIE V	M
AEROSMITH	M
AFRICANISM	M
AFROJACK	M
AFTER THE FIRE	M
AGNETHA FALTSKOG	F
AIR SUPPLY	M
AL GREEN	M
AL GREEN WITH ANNIE LENNOX	M/F
AL JARREAU	M
AL MARTINO	M
AL STEWART	M
ALABAMA	M
ALAN BOWN SET	M
ALAN PARSONS PROJECT	M
ALAN PRICE SET	M
ALAN SORRENTI	M
ALAN WALKER	M
ALANIS MORISSETTE	M
ALANNAH MYLES	M
ALARM	M
ALBERT COLLINS	M
ALBERT HAMMOND	M
ALBERT KING	M
ALCAZAR	M
ALDO NOVA	M
ALED JONES	M
ALED JONES AND SIR TERRY WOGAN	M
ALEX PARKS	M
ALEXANDER O'NEAL	M
ALEXANDER O'NEAL AND CHERELLE	M
ALEXIS JORDAN	F
ALFRED MARKS	M
ALIAS	M
ALICE BOMAN	F
ALICE COOPER	M
ALICE IN CHAINS	M
ALICE MARTINEAU	F
ALICIA KEYS	F
ALISHAS ATTIC	F
ALISON KRAUSS	F
ALISON KRAUSS AND UNION STATION	M/F
ALISON LIMERICK	F
ALISON MOYET	F
ALL ABOUT EVE	M
ALL SAINTS	F
ALLMAN BROTHERS BAND	M
ALMA COGAN	F
ALPHABEAT	M
ALPHAVILLE	M
ALTERED IMAGES	M/F
ALVIN CASH & THE CRAWLERS	M
ALVIN ROBINSON	M
AMAZULU	M/F
AMBROSIA	M
AMEN	M
AMEN CORNER	M
AMEN UK	M
AMERICA	M
AMII STEWART	F
AMY STUDT	F
ANASTACIA	F
ANDREA TRUE CONNECTION	M
ANDREW GOLD	M
ANDREWS SISTERS	F
ANDY KIM	M
ANDY WILLIAMS	M
ANEKA	F
ANGEL WITCH	F
ANGELIQUE KIDJO	F
ANGELS	M
ANGLOS	M
ANGRY ANDERSON	M
ANIMALS	M
ANIMOTION	M
ANITA BAKER	F
ANITA HARRIS	F
ANITA WARD	F
ANN MARGARET	F
ANN PEEBLES	F
ANNE MURRAY	F
ANNE SHELTON	F
ANNIE LENNOX	F
ANNIE LENNOX FEAT. PAUL SIMON	M/F
ANOTHER LEVEL	M
ANT AND DEC	M
ANTHONY NEWLEY	M
APPLEJACKS	M/F
APPLETON	M
APRIL WINE	M
AQUA	M
AQUA VELVA	M
AQUALUNG	M
ARCADIA	M
ARCHIE BELL AND THE DRELLS	M
ARCHIES	M
ARCHITECHS FEAT. NANA	M/F
ARETHA FRANKLIN	F
ARETHA FRANKLIN AND GEORGE BENSON	F
ARETHA FRANKLIN AND GEORGE MICHAEL	F
ARGENT	M
ARID	M
ARLO GUTHRIE	M
ARRIVAL	M
ARROWS	M
ART GARFUNKEL	M
ART OF NOISE FEAT. TOM JONES	M
ARTFUL DODGER FEAT. LIFFORD	M
ARTFUL DODGER FEAT. ROMINA JOHNSON	M
ARTHUR CONLEY	M
ARTIST UNITED FOR NATURE	M
ASH	M
ASHAYE	M
ASHFORD AND SIMPSON	M
ASIA	M
ASSOCIATES	M
ASSOCIATION	M
ASWAD	M
ATHLETE	M
ATLANTA RHYTHM SECTION	M
ATLANTIC STARR	M
ATOMIC KITTEN	F
ATOMIC ROOSTER	M
ATTACK	M
ATTIC LIGHTS	M
AURORA	M
AUSTIN FAITHFULL	M
AUTOMATIC	M
AVA MAX	F
AVERAGE WHITE BAND	M
AVICII	M
AVIS	M
AVONS	F
AVRIL LAVIGNE	F
AZTEC CAMERA	M
AZURE RAY	M
AZZIDO DA BASS	M
B WITCHED	F
B-52'S	M
B. BUMBLE AND THE STINGERS	M
B.B. AND Q. BAND	M
B.B. KING	M
BABY D	M
BABY WASHINGTON	M
BABYBIRD	M
BABYLON ZOO	M
BABYS	M
BACHELORS	M
BACHMAN TURNER OVERDRIVE	M
BACKSTREET BOYS	M
BAD COMPANY	M
BAD ENGLISH	M
BAD MANNERS	M
BADLY DRAWN BOY	M
BAJA MARIMBA BAND	M
BALITO CREPE MIST STOCKINGS	M
BALLOON FARM	M
BALTIMORA	M/F
BANANARAMA	F
BANANARAMA WITH FUN BOY THREE	M/F
BAND	M
BAND AID	M
BAND AID 20	M
BAND AID 2004	M
BAND OF BEES	M
BANGLES	F
BAR-KAYS	M
BARBARA ACKLIN	F
BARBARA ANN	F
BARBARA DICKSON	F
BARBARA DICKSON AND ELAINE PAIGE	F
BARBARA LEWIS	F
BARBARA LYNN	F
BARBARA MASON	F
BARBARA MCNAIR	F
BARBARA RANDOLPH	F
BARBARIANS	M
BARBRA STREISAND	F
BARBRA STREISAND & BARRY GIBB	M/F
BARCLAY JAMES HARVEST	M
BARDO	F
BARENAKED LADIES	M
BARRACUDAS	M
BARRETT STRONG	M
BARRY BENSON	M
BARRY BLUE	M
BARRY GRAY ORCHESTRA	M
BARRY MANILOW	M
BARRY MCGUIRE	M
BARRY WHITE	M
BASEMENT JAXX (FEAT. LISA KEKAULA)	M
BASTILLE	M
BAY CITY ROLLERS	M
BB AND Q BAND	M
BBE	M
BBMAK	M
BE BOP DELUXE	M
BE GOOD TANYAS	F
BEACH BOYS	M
BEACH-NUTS	M
BEAN AND LOOPY'S LOT	M
BEAT	M
BEATCHUGGERS FEAT. ERIC CLAPTON	M
BEATFREAKZ	M
BEATLES	M
BEATLES WITH TONY SHERIDAN	M
BEATMASTERS	M
BEATMASTERS FEAT. MC MERLIN	M
BEATS INTERNATIONAL	M
BEATS INTERNATIONAL FEAT. LINDY LAYTON	M
BEAUTIFUL SOUTH	M
BEDROCKS	M
BEE GEES	M
BEGGAR AND CO	M
BELFAST GYPSIES	M
BELINDA CARLISLE	F
BELLAMY BROTHERS	M
BELLE STARS	F
BELLEFIRE	M
BELOUIS SOME	M
BELOVED	M
BEN E. KING	M
BEN JELEN	M
BEN PRESTON	M
BEN'S BROTHER	M
BENNY CARTER	M
BENNY GOODMAN	M
BENNY SPELLMAN	M
BERLIN	M
BERN ELLIOTT AND THE FENMEN	M
BERRI	M
BERT JANSCH	M
BERT KAEMPFERT	M
BERT WEEDON	M
BETH NIELSEN CHAPMAN	F
BETH ORTON	F
BETTE MIDLER	F
BETTY BOO	F
BETTY EVERETT	F
BEVERLEY ANN	F
BEVERLEY CRAVEN	F
BEVERLEY SISTERS	F
BEVERLY KNIGHT FEAT. REDMAN	F
BIBLE	M
BIG AUDIO DYNAMITE	M
BIG BOPPER	M
BIG BROTHER AND THE HOLDING COMPANY	M
BIG C CLUB	M
BIG COUNTRY	M
BIG DEE IRWIN	M
BIG FUN	M
BIG MOUNTAIN	M
BIG SOUND AUTHORITY	M
BIG SUGAR	M
BIG THREE	M
BILL BLACK'S COMBO	M
BILL HALEY AND HIS COMETS	M
BILL HALEY AND THE COMETS	M
BILL LOVELADY	M
BILL WITHERS	M
BILLIE	F
BILLIE ANTHONY	F
BILLIE DAVIS	F
BILLIE JO SPEARS	F
BILLIE MYERS	F
BILLIE PIPER	F
BILLY ECKSTINE	M
BILLY ECKSTINE AND SARAH VAUGHAN	M/F
BILLY FURY	M
BILLY GRIFFIN	M
BILLY IDOL	M
BILLY J. KRAMER	M
BILLY J. KRAMER AND THE DAKOTAS	M
BILLY JOE ROYAL	M
BILLY JOEL	M
BILLY MAY	M
BILLY OCEAN	M
BILLY PAUL	M
BILLY PRESTON	M
BILLY RAY CYRUS	M
BILLY SQUIER	M
BILLY STEWART	M
BILLY SWAN	M
BILLY WILLIAMS	M
BING CROSBY	M
BING CROSBY AND DAVID BOWIE	M
BIRDS	M
BIZARRE	M
BIZARRE INC.	M
BJORK	F
BJORN AGAIN	M
BLACK	M
BLACK BOX	M
BLACK CROWES	M
BLACK EYED PEAS	M
BLACK LEGEND	M
BLACK SABBATH	M
BLACK SLATE	M
BLACK VELVET	M
BLACKFOOT	M
BLACKFOOT SUE	M
BLANCMANGE	M
BLAS CANTÓ	M
BLAZIN' SQUAD	M
BLESSID UNION OF SOULS	M
BLONDIE	M/F
BLOOD SWEAT & TEARS	M
BLOOD SWEAT AND TEARS	M
BLOODHOUND GANG	M
BLOSSOMS	F
BLOW MONKEYS	M
BLUE	M
BLUE AEROPLANES	M
BLUE BOY	M
BLUE CHEER	M
BLUE MAGOOS	M
BLUE MERCEDES	M
BLUE MINK	M
BLUE NILE	M
BLUE OYSTER CULT	M
BLUE PEARL	M
BLUE RONDOS	M
BLUE SUEDE	M
BLUE THINGS	M
BLUE ZOO	M
BLUEBELLS	M
BLUES TRAVELER	M
BLUETONES	M
BLUR	M
BO STREET RUNNERS	M
BOB AND EARL	M
BOB B. SOXX AND THE BLUE JEANS	M
BOB CREWE GENERATION	M
BOB DYLAN	M
BOB LEAPER ORCHESTRA	M
BOB LIND	M
BOB MARLEY	M
BOB MARLEY AND THE WAILERS	M
BOB SEGER AND THE SILVER BULLET BAND	M
BOB SINCLAR	M
BOBBIE GENTRY	F
BOBBIE GENTRY AND GLEN CAMPBELL	M/F
"BOBBY ""BORIS"" PICKETT"	M
BOBBY BROWN	M
BOBBY CURTOLA	M
BOBBY DARIN	M
BOBBY DAY	M
BOBBY FULLER FOUR	M
BOBBY GOLDSBORO	M
BOBBY HEBB	M
BOBBY HELMS	M
BOBBY MCFERRIN	M
BOBBY THURSTON	M
BOBBY VEE	M
BOBBY WOMACK	M
BODYSNATCHERS	M
BOMB THE BASS	M
BOMBAY BICYCLE CLUB	M
BOMFUNK MC'S	M
BON JOVI	M
BONEY M	M
BONNIE RAITT	F
BONNIE TYLER	F
BONZO DOG DOO-DAH BAND	M
BOO RADLEYS	M
BOOGIE BOX HIGH	M
BOOKER T & THE MG'S	M
BOOKER T AND THE MG'S	M
BOOMTOWN RATS	M
BORIS GARDINER	M
BORIS PICKETT	M
BOSTON	M
BOSTON CRABS	M
BOURGEOIS TAGG	M
BOW WOW WOW	M
BOX TOPS	M
BOY GEORGE	M
BOY MEETS GIRL	M
BOYS DON'T CRY	M
BOYS TOWN GANG	M
BOYZ TO MEN	M
BOYZONE	M
BOZ	M
BOZ SCAGGS	M
BRAND	M
BRAND NEW HEAVIES	M
BRANDON FLOWERS	M
BRANDS	M
BRANDY	F
BRASS CONSTRUCTION	M
BREAD	M
BREATHE	M
BRENDA HOLLOWAY	F
BRENDA LEE	F
BRENDA RUSSELL	F
BRENDAN BENSON	M
BRENTON WOOD	M
BRIAN ENO	M
BRIAN HYLAND	M
BRIAN KENNEDY	M
BRIAN MAY	M
BRIAN MCFADDEN	M
BRIAN MCFADDEN AND DELTA GOODREM	M/F
BRIAN POOLE AND THE TREMELOES	M
BRIGHTON	M
BRITNEY SPEARS	F
BROADSIDE	M
BROKEN ENGLISH	M
BRONSKI BEAT	M
BROOK BENTON	M
BROOKLYN BRIDGE	M
BROS	M
BROTHER BEYOND	M
BROTHERHOOD OF MAN	M
BROTHERS	M
BROTHERS IN RHYTHM	M
BROTHERS JOHNSON	M
BRUCE CHANNEL	M
BRUCE COCKBURN	M
BRUCE HORNSBY	M
BRUCE SPRINGSTEEN	M
BRUCE WILLIS	M
"BRUNO MARS, ANDERSON .PAAK & SILK SONIC"	M
BRYAN ADAMS	M
BRYAN FERRY	M
BUCKS FIZZ	M/F
BUDDY HOLLY	M
BUDDY HOLLY AND THE CRICKETS	M
BUDDY KNOX	M
BUFFALO SPRINGFIELD	M
BUFFY SAINTE-MARIE	F
BUGGLES	M
BURL IVES	M
BURT BACHARACH	M
BURT BACHARACH & HIS ORCHESTRA FEATURING TONY MIDD	M
BUSTED	M
BUTTHOLE SURFERS	M
BUZZCOCKS	M
BWO	M
BYRDS	M
BYSTANDERS	M
CADILLACS	M
CALIFORNIANS	M
CALLING	M
CALUM SCOTT	M
CALVIN HARRIS	M
CALVIN JAMES	M
CAMEO	M
CAMISRA	M
CANDI STATON	F
CANNED HEAT	M
CAPITOLS	M
CAPTAIN	M/F
CAPTAIN AND TENNILLE	M/F
CAPTAIN SENSIBLE	M
CARAVELLES	M
CARDIGANS	M/F
CARL DOUGLAS	M
CARL PERKINS	M
CARLA BRUNI	M
CARLY SIMON	F
CARMEL	M
CAROL CONNORS	F
CAROLE BAYER SAGER	F
CAROLE KING	F
CAROLYN CARTER	F
CARON WHEELER	F
CARPENTERS	M/F
CARROLLS	M
CARS	M
CARTER WOOD	M
CARTOONS	M
CASCADES	M
CASUALS	M
CAT STEVENS	M
CATATONIA	M/F
CATHY DENNIS	F
CATS	M
CAUSES	M
CCS	M
CE CE PENISTON	F
CELINE DION	F
CEVIN FISHER FEAT RAMONA KELLER	M
CHAIRMAN OF THE BOARD	M
CHAKA KHAN	M
CHAMBERS BROTHERS	M
CHAMPAIGN	M
CHAMPS	M
CHANCES ARE	M
CHANGE	M
CHANNELS	M
CHANTS	F
CHARLATANS	M
CHARLENE	F
CHARLES & EDDIE	M
CHARLES BOYER	M
CHARLES DICKENS	M
CHARLIE DANIELS BAND	M
CHARLIE GRACIE	M
CHARLIE RICH	M
CHARLOTTE OC	F
CHASE & STATUS	M
CHEAP TRICK	M
CHER	F
CHERRELLE	F
CHERRY GHOST	M
CHERYL COLE	F
CHESNEY HAWKES	M
CHET BAKER	M
CHI LITES	M
CHIC	M
CHICAGO	M
CHICKEN SHACK	M
CHICKEN SHED THEATRE	M/F
CHIFFONS	M
CHILLIWACK	M
CHIMES	M
CHINA BLACK	M
CHINA CRISIS	M
CHORDETTES	M
CHORDS	M
CHRIS ANDREWS	M
CHRIS BROWN	M
CHRIS CLARK	M
CHRIS DE BURGH	M
CHRIS FARLOWE	M
CHRIS ISAAK	M
CHRIS MONTEZ	M
CHRIS REA	M
CHRIS SPEDDING	M
CHRIS THOMPSON	M
CHRISSIE HYNDE	F
CHRISTIANS	M
CHRISTINA AGUILERA	F
CHRISTINE AND THE QUEENS	F
CHRISTINE MCVIE	F
CHRISTOPHER CROSS	M
CHROMATICS	M
CHUBBY CHECKER	M
CHUCK BERRY	M
CHUMBAWAMBA	M
CHURCH	M
CILLA BLACK	F
CINDERELLA	F
CITY BOY	M
CLAMARAN ANTOINE PRESENTS D-PLAC	M
CLANNAD	M/F
CLARENCE CLEMONS	M
CLARENCE FROGMAN HENRY	M
CLASH	M
CLASSICS IV	M
CLASSIX NOUVEAUX	M
CLEAN BANDIT	M
CLEAN BANDIT FEAT. ZARA LARSSON	M/F
CLIFF BENNETT AND THE REBEL ROUSERS	M
CLIFF RICHARD	M
CLIFF RICHARD AND PHIL EVERLY	M
CLIFFORD T. WARD	M
CLIMAX BLUES BAND	M
CLIMIE FISHER	M
CLINTON FORD	M
CLODAGH RODGERS	F
CLOUT	M
CLOVERS	M
CLOVES	M
CLUB NOUVEAU	M
CLYDE MCPHATTER	M
COAST TO COAST	M
COASTERS	M
COCK ROBIN	M
CODY SIMPSON	M
COLA BOY	M
COLDPLAY	M
COLDPLAY & BTS	M
COLIN BLUNSTONE	M
COLLEGE AND ELECTRIC YOUTH	M
COLONEL ABRAMS	M
COLOUR ME BADD	M
COLOURFIELD	M
COMMODORES	M
COMMUNARDS	M
CONNELLS	M
CONNIE FRANCIS	F
CONNIE STEVENS	F
CONTI MUNTI	M
CONTOURS	M
CONWAY TWITTY	M
CORAL	M
COREY HART	M
CORNERSHOP	M
CORRS	M/F
COSMIC ROUGH RIDERS	M
COUGARS	M
COUNT FIVE	M
COUNTING CROWS	M
COUNTRY JOE AND THE FISH	M
COVERDALE PAGE	M
COWSILLS	M/F
COZY POWELL	M
CRAIG DAVID	M
CRAIG DOUGLAS	M
CRAIG MCLACHLAN	M
CRAIG PHILLIPS	M
CRAMPS	M
CRANBERRIES	M/F
CRASH TEST DUMMIES	M
CRAVING	M
CRAZY ELEPHANT	M
CRAZY WORLD OF ARTHUR BROWN	M
CREAM	M
CREATION	M
CREEDENCE CLEARWATER REVIVAL	M
CRESTS	M
CREW CUTS	M
CRICKETS	M
CRISPIAN ST PETERS	M
CRITTERS	M
CROSBY STILLS AND NASH	M
CROWDED HOUSE	M
CROWN HEIGHTS AFFAIR	M
CRUSADERS	M
CRYIN' SHAMES	M
CRYSTAL GAYLE	F
CRYSTALS	F
CULT	M
CULTURE CLUB	M
CULTURE SHOCK	M
CUNNINGHAM	M
CUPIDS INSPIRATION	M
CURE	M
CURIOSITY KILLED THE CAT	M
CURTIS LEE	M
CURTIS MAYFIELD	M
CURTIS MAYFIELD AND THE IMPRESSIONS	M
CURTIS STIGERS	M
CURVED AIR	M
CUTTING CREW	M
CYNDI LAUPER	F
CYRKLE	M
D TRAIN	M
D-SIDE	M
D;REAM	M
DA MUTTZ	M
DAFT PUNK	M
DAKOTA STATON	M
DAKOTAS	M
DALBELLO	M
DALTON BOYS	M
DAMAGE	M
DAMIEN RICE	M
DAMN YANKEES	M
DAN FOGELBERG	M
DAN HARTMAN	M
DAN HILL	M
DAN REED NETWORK	M
DANA VALERY	M
DANDY WARHOLS	M
DANIEL BEDINGFIELD	M
DANIEL BOONE	M
DANIEL POWTER	M
DANNII	F
DANNII MINOGUE	F
DANNY & THE JUNIORS	M
DANNY DAY	M
DANNY MIRROR	M
DANNY O'KEEFE	M
DANNY WILLIAMS	M
DANNY WILSON	M
DARIO G	M
DARIUS	M
DARKNESS	M
DARLENE LOVE	F
DARLENE LOVE AND THE E STREET BAND	F
DARLING BUDS	M/F
DARRELL BANKS	M
DARROW FLETCHER	M
DARUDE	M
DARYL HALL	M
DAVE BERRY	M
DAVE CLARK FIVE	M
DAVE DAVIES	M
DAVE DEE DOZY BEAKY MICK & TICH	M
DAVE DEE DOZY BEAKY MICK AND TICH	M
DAVE EDMUNDS	M
DAVE EDMUNDS AND LOVE SCULPTURE	M
DAVE KING	M
DAVE MASON	M
DAVE STEWART	M
DAVE STEWART AND BARBARA GASKIN	M/F
DAVID & DAVID	M
DAVID A STEWART	M
DAVID AND JONATHAN	M
DAVID BOWIE	M
DAVID BOWIE AND MICK JAGGER	M
DAVID BOWIE AND THE LOWER THIRD	M
DAVID BOX	M
DAVID CASSIDY	M
DAVID CHRISTIE	M
DAVID DUNDAS	M
DAVID ESSEX	M
DAVID GARRICK	M
DAVID GATES	M
DAVID GRANT AND JAKI GRAHAM	M/F
DAVID GRAY	M
DAVID HASSELHOFF	M
DAVID JORDAN	M
DAVID KNOPFLER	M
DAVID LEE ROTH	M
DAVID LINDLEY	M
DAVID MCWILLIAMS	M
DAVID MEAD	M
DAVID PARTON	M
DAVID ROSE ORCHESTRA	M
DAVID SNEDDON	M
DAVID SOUL	M
DAVID SYLVIAN	M
DAVID WHITFIELD	M
DAVIE JONES AND THE KING BEES	M
DAZZ BAND	M
DB BOULEVARD	M
DE LA SOUL	M
DE NUIT	M
DEACON BLUE	M
DEAD OR ALIVE	M
DEAN LEWIS	M
DEAN MARTIN	M
DEAN MARTIN & HELEN O'CONNELL	M/F
DEAN PARRISH	M
DEBARGE	M
DEBBIE GIBSON	F
DEBBIE HARRY	F
DEBBIE HARRY & IGGY POP	M/F
DEBBIE REYNOLDS	F
DEE C. LEE	F
DEE CLARK	F
DEE MULLINS	F
DEEP BLUE SOMETHING	M
DEEP PURPLE	M
DEL AMITRI	M
DEL SHANNON	M
DEL VIKINGS	M
DEL-VIKINGS	M
DELANEY & BONNIE	M/F
DELANEY & BONNIE & FRIENDS	M/F
DELFONICS	M
DELIRIUM FEAT. SARAH MCLACHLAN	M/F
DELLA REESE	F
DELTA GOODREM	F
DENIECE WILLIAMS	F
DENNIS EDWARDS FEAT. SIEDAH GARRET	M
DENNIS LOTIS	M
DENNIS TURNER	M
DENNISONS	M
DEPARTMENT S	M
DEPECHE MODE	M
DEREK AND THE DOMINOS	M
DEREK GARDNER	M
DERRICK AND PATSY	M
DERRICK HARRIOTT	M
DESIRE	M
DESIRELESS	M
DESMOND DEKKER AND THE ACES	M
DESREE	F
DESTINY'S CHILD	M
DETROIT EMERALDS	M
DETROIT SPINNERS	M
DEXYS MIDNIGHT RUNNERS	M
DIAMONDS	M
DIANA CARROLL	F
DIANA KING	F
DIANA ROSS	F
DIANA ROSS AND LIONEL RICHIE	M/F
DIANA ROSS AND THE SUPREMES	M/F
DICK DALE AND HIS DELTONES	M
DICK JAMES	M
DICKEY LEE	M
DICKIE VALENTINE	M
DIDO	F
DILLINGER	M
DINA CARROLL	F
DINAH SHORE	F
DINOSAUR JR.	M
DION	M
DION & THE BELMONTS	M
DIONNE WARWICK	F
DIONNE WARWICK AND LUTHER VANDROS	F
DIRE STRAITS	M
DIRTY DOZEN BRASS BAND FEAT. NORAH JONES	M
DISCLOSURE	M
DISCO TEX & THE SEX-O-LETTES	M
DISSOCIATIVES	M
DIVINE	M
DIVINE COMEDY	M
DIVINYLS	M
DIXIE CHICKS	F
DIXIE CUPS	F
DJ DISCIPLE	M
DJ JAZZY JEFF & THE FRESH PRINCE	M
DJ QUICKSILVER	M
DJ ROLANDO A.K.A. AZTEC MYSTIC	M
DJ SAKIN AND FRIENDS	M
DJ SAMMY	M
DMA'S	M
DOBIE GRAY	M
DOC HOLLIDAY	M
DOCTOR AND THE MEDICS	M
DODGY	M
DOGS DIE IN HOT CARS	M
DOLLAR	M/F
DOLLY PARTON	F
DOLLY PARTON AND KENNY ROGERS	F
DON AND DEWEY	M
DON FARDON	M
DON HENLEY	M
DON HENLEY & BRUCE HORNSBY	M
DON JOHNSON	M
DON LANG	M
DON MCLEAN	M
DON PARTRIDGE	M
DONALD FAGEN	M
DONNA LEWIS	F
DONNA SUMMER	F
DONNIE ELBERT	M
DONOVAN	M
DOOBIE BROTHERS	M
DOOLALLY	M
DOORS	M
DOPE SMUGGLAZ	M
DORIAN GRAY	M
DORIS DAY	F
DORIS TROY	F
DOROTHY MOORE	F
DOROTHY SQUIRES	F
DORSEY BURNETTE	M
DOUBLE	M
DOWLANDS	M
DOWNBEATS	M
DOWNLINERS SECT	M
DR ALBAN	M
DR FEELGOOD	M
DR HOOK	M
DREAM ACADEMY	M
DRIFTERS	M
DRIZA BONE	M
DUANE EDDY	M
DUANE HARDEN	M
DUFFY POWER	M
DUKE ELLINGTON	M
DUNCAN BROWNE	M
DUNCAN FAURE	M
DUNCAN JAMES	M
DURAN DURAN	M
DUSTY SPRINGFIELD	F
DYNAMICS	M
E-17	M
E.L.O	M
EAGLE EYE CHERRY	M
EAGLES	M
EARL VAN DYKE & THE SOUL BROTHERS	M
EARTH & FIRE	M
EARTH WIND & FIRE	M
EASYBEATS	M
ECHO	M
ECHO AND THE BUNNYMEN	M
ECHOBELLY	M
ECHOSMITH	M
ECLIPSE	M
ED HARCOURT	M
ED SHEERAN	M
EDDIE & THE HOT RODS	M
EDDIE CALVERT	M
EDDIE COCHRAN	M
EDDIE FISHER	M
EDDIE FLOYD	M
EDDIE HODGES	M
EDDIE HOLMAN	M
EDDIE MONEY	M
EDDIE MURPHY & RICK JAMES	M
EDDIE RABBITT	M
EDDY ARNOLD	M
EDDY GRANT	M
EDEN KANE	M
EDIE BRICKELL & THE NEW BOHEMIANS	M
EDISON LIGHTHOUSE	M
EDWARD BEAR	M
EDWIN HAWKINS SINGERS	M
EDWIN MCCAIN	M
EDWIN STARR	M
EDWYN COLLINS	M
EELS	M
EG	M
EIGHTH WONDER	M
EL PRESIDENTE	M
ELASTICA	M
ELBOW	M
ELECTRIC	M
ELECTRIC PRUNES	M
ELECTRIC SIX	M
ELECTRONIC	M
ELGINS	M
ELIAS AND HIS ZIG ZAGS	M
ELIDA	M
ELIZABETH GOTTEN & BRENDA EVANS	F
ELKIE BROOKS	F
ELLA FITZGERALD	F
ELLIE CAMPBELL	F
ELLIE GOULDING	F
ELTON JOHN	M
ELTON JOHN & KIKI DEE	M/F
ELVIN BISHOP	M
ELVIS COSTELLO	M
ELVIS PRESLEY	M
EMBRACE	M
EMF	M
EMILE FORD & THE CHECKMATES	M
EMILIA	F
EMMA BUNTON	F
EMMA REDE	F
EMMYLOU HARRIS	F
EMMYLOU HARRIS & MARK KNOPFLER	M/F
EMOTIONS	M
EMPIRE OF THE SUN	M
EN VOGUE	M
ENGELBERT HUMPERDINCK	M
ENGINEERS	M
ENGLAND DAN & JOHN FORD COLEY	M
ENGLAND SISTERS	F
ENGLISH BEAT	M
ENIGMA	M
ENNIO MORRICONE	M
ENRIQUE IGLESIAS	M
ENYA	F
EPHRAIM LEWIS	M
EPISODE SIX	M
EQUALS	M
ERASURE	M
ERIC BURDON	M
ERIC BURDON & THE ANIMALS	M
ERIC CARMEN	M
ERIC CLAPTON	M
ERIC PRYDZ	M
ERMA FRANKLIN	F
ERNIE K-DOE	M
ERNIE MARESCA	M
ERROL DUNKLEY	M
ESCORTS	M
ESSEX	M
ESTHER & ABI OFARIM	M/F
ESTHER PHILLIPS	F
ETERNAL	M
ETHIOPIANS	M
ETTA JAMES	M
EUROPE	M
EURYTHMICS	M/F
EURYTHMICS & ARETHA FRANKLIN	M/F
EVA CASSIDY	F
EVAN DANDO	M
EVANESCENCE	M
EVE BOSWELL	F
EVELYN 'CHAMPAGNE' KING	F
EVELYN THOMAS	F
EVERCLEAR	M
EVERLY BROTHERS	M
EVERYTHING BUT THE GIRL	M/F
EWAN & JERRY	M
EXILE	M
EXPOSE	M
EXTREME	M
F.R. DAVID	M
FABULOUS THUNDERBIRDS	M
FACES	M
FACTOTUMS	M
FAIRGROUND ATTRACTION	M
FAIRPORT CONVENTION	M
FAITH HILL	F
FAITH NO MORE	F
FAITHLESS	M
FAMILY	M
FAMILY DOGG	M
FANTASTICS	M
FAR CORPORATION	M
FARM	M
FASHION	M
FAT LARRY'S BAND	M
FATBACK BAND	M
FATBOY SLIM	M
FATHER JACK	M
FATS DOMINO	M
FEARGAL SHARKEY	M
FEDERALS	M
FEEDER	M
FEELING	M
FELICE TAYLOR	F
FELIX	M
FERN KINNEY	F
FFITCH	M
FICTION FACTORY	M
FIERCE	M
FIFTH AVENUE	M
FINE YOUNG CANNIBALS	M
FINIS HENDERSON	M
FINK	M
FINLEY QUAYE	M
FINN BROTHERS	M
FIRST CLASS	M
FIRST EDITION	M
FISCHER-Z	M
FIVE	M
FIVE FOR FIGHTING	M
FIVE KEYS	M
FIVE MAN ELECTRICAL BAND	M
FIVE SATINS	M
FIVE STAR	M/F
FIXX	M
FLAMING LIPS	M
FLAMINGOS	M
FLAMMA SHERMAN	M
FLASH & THE PAN	M
FLASHDANCE	M
FLEET FOXES	M
FLEETWOOD MAC	M/F
FLEETWOODS	M
FLETCHER HENDERSON	M
FLIES	M
FLIRTATIONS	F
FLORENCE + THE MACHINE	F
FLOWER POT MEN	M
FLOYD ROBINSON	M
FLUKE	M
FLYING LIZARDS	M
FLYING PICKETS	M
FOALS	M
FOCUS	M
FONTELLA BASS	F
FOO FIGHTERS	M
FORCE MD'S	M
FORCE WEST	M
FOREIGNER	M
FORREST	M
FORTUNES	M
FOSTER THE PEOPLE	M
FOUNDATIONS	M
FOUNTAINHEAD	M
FOUNTAINS OF WAYNE	M
FOUR ACES	M
FOUR FRESHMEN	M
FOUR PENNIES	M
FOUR PREPS	M
FOUR SEASONS	M
FOUR TOPS	M
FOURMOST	M
FOXES	F
FPI PROJECT	M
FRAGMA	M
FRANCE GALL	M
FRANCES	F
FRANCES NERO	F
FRANCOISE HARDY	F
FRANK IFIELD	M
FRANK SINATRA	M
FRANK WILSON	M
FRANKIE AVALON	M
FRANKIE GOES TO HOLLYWOOD	M
FRANKIE KNUCKLES	M
FRANKIE LAINE	M
FRANKIE LYMON & THE TEENAGERS	M
FRANKIE MILLER	M
FRANKIE VALLI	M
FRANKIE VAUGHAN	M
FRANKMUSIK	M
FRAY	M
FRAZIER CHORUS	M
FREAKS OF NATURE	M
FREDA PAYNE	F
FREDDIE AND THE DREAMERS	M
FREDDIE BELL AND THE BELLBOYS	M
FREDDIE JACKSON	M
FREDDIE LENNON	M
FREDDIE RYDER	M
FREDDY CANNON	M
FREE	M
FREEEZ	M
FREEMAN BROTHERS	M
FREIHEIT	M
FREUR	M
FRIDA	F
FRIDA & PHIL COLLINS	M/F
FRIEND & LOVER	M
FRIENDS OF DISTINCTION	M
FRIJID PINK	M
FRITZ KALKBRENNER	M
FUN BOY 3	M
FUN BOY THREE FEAT. BANANARAMA	M
FUN LOVIN' CRIMINALS	M
FURNITURE	M
GABRIELLE	F
"GALANTIS, DAVID GUETTA & LITTLE MIX"	M
GALAXY	M
GALE GARNETT	M
GALLAGHER & LYLE	M
GAP BAND	M
GARBAGE	M
GARETH GATES	M
GARNET MIMMS	M
GARY BARLOW	M
GARY BARLOW & ELTON JOHN	M
GARY BARLOW & THE COMMONWEALTH BAND	M
GARY BROOKER	M
GARY EDWARDS COMBO	M
GARY KEMP	M
GARY LEWIS AND THE PLAYBOYS	M
GARY MILLER & THE BARRY GRAY ORCHESTRA	M
GARY MILLER WITH RAY MARTIN'S CHORUS AND ORCHESTRA	M
GARY MOORE	M
GARY NUMAN	M
GARY PUCKETT AND THE UNION GAP	M
GARY US BONDS	M
GARY WRIGHT	M
GAS COMPANY	M
GAYLETS	M
GAYLORDS	M
GAZEBO	M
GEMMA HAYES	F
GEMS	F
GENE	M
GENE CHANDLER	M
GENE LOVES JEZEBEL	M
GENE PITNEY	M
GENE VINCENT	M
GENERATION X	M
GENESIS	M
GENO WASHINGTON & THE RAM JAM BAND	M
GEORDIE	M
GEORGE ACOSTA	M
GEORGE BAKER SELECTION	M
GEORGE BENSON	M
GEORGE BENSON & VICKI RANDALL	M/F
GEORGE EZRA	M
GEORGE HARRISON	M
GEORGE MCCRAE	M
GEORGE MICHAEL	M
GEORGE SHEARING QUINTET	M
GEORGE THOROGOOD & THE DESTROYERS	M
GEORGIA SATELLITES	M
GEORGIE FAME	M
GERALD ALSTON	M
GERARD KENNY	M
GERI HALLIWELL	F
GERRY AND THE PACEMAKERS	M
GERRY RAFFERTY	M
GHOSTS	M
GIBSON BROTHERS	M
GIBSON GUITARS	M
GIBSONS	M
GIFTCO	M
GIGOLO AUNTS	M
GILBERT O'SULLIVAN	M
GILLAN	M
GIN BLOSSOMS	M
GIORGIO MORODER WITH PHILIP OAKEY	M
GIRL THING	M
GIRLS ALOUD	F
GIRLS HERE FIRST	F
GLADYS KNIGHT	F
GLADYS KNIGHT & THE PIPS	M/F
GLASS TIGER	M
GLEN CAMPBELL	M
GLEN JONES	M
GLENFLEX INSTANT SKIRTS	M
GLENN FREY	M
GLENN MEDEIROS	M
GLENN MILLER	M
GLITTER BAND	M
GLORIA ESTEFAN	F
GLORIA ESTEFAN AND THE MIAMI SOUND MACHINE	M/F
GLORIA GAYNOR	F
GLORIA JONES	F
GLORIA LYNNE	F
GNARLS BARKLEY	M
GO WEST	M
GO-BETWEENS	M
GODLEY & CREME	M
GOGO'S	F
GOLDEN EARRING	M
GOLDFRAPP	M
GOLDIE	F
GOLDIE & THE GINGERBREADS	F
GOLDSPOT	M
GONZALES	M
GOO GOO DOLLS	F
GOOD CHARLOTTE	F
GORDON LIGHTFOOT	M
GRACE JONES	F
GRACIE FIELDS	F
GRAHAM BOND ORGANISATION	M
GRAHAM BONNET	M
GRAHAM BONNEY	M
GRAND DRIVE	M
GRAND FUNK RAILROAD	M
GRANDADDY	M
GRANDMASTER FLASH	M
GRANDMASTER FLASH & THE FURIOUS FIVE	M
GRANT LEE PHILLIPS	M
GREEN DAY	M
GREG KIHN BAND	M
GREG LAKE	M
GREGG ALLMAN	M
GREGORY ABBOTT	M
GREGORY ALAN ISAKOV	M
GREGORY HINES & LUTHER VANDROSS	M
GREYHOUND	M
GRIFF	M
GROVER WASHINGTON JNR	M
GUESS WHO	M
GUILLEMOTS	M
GUN	M
GUNS 'N' ROSES	M
GURU JOSH	M
GUY DARRELL	M
GUY MITCHELL	M
GUYS FROM U.N.C.L.E.	M
GWEN GUTHRIE	F
GWEN STEFANI	F
H2O	M
HADDAWAY	M
HAIRCUT 100	M
HALL & OATES	M
HAMILTON JOE FRANK & REYNOLDS	M
HAPPY MONDAYS	M
HARMONY GRASS	M
HAROLD FALTERMEYER	M
HAROLD MELVIN & THE BLUENOTES	M
HARPERS BIZARRE	M
HARPO	M
HARRISON GIBSON	M
HARRY BELAFONTE	M
HARRY CHAPIN	M
HARRY J ALLSTARS	M
HARRY SECOMBE	M
HARRY STYLES	M
HARVEY & THE MOONGLOWS	M
HATTIE LITTLES	M
HAWAII	M
HAWKWIND	M
HAYSI FANTAYZEE	F
HAYWOODE	M
HAZEL O'CONNOR	F
HAZELL DEAN	F
HEADLINERS	M
HEALY & AMOS	M
HEART	M/F
HEART OF ICE	M
HEARTBEAT	M
HEATHER NOVA	M
HEATHER SMALL	F
HEATWAVE	M
HEAVEN 17	M
HEDGEHOPPERS ANONYMOUS	M
HEINZ	M
HEINZ & THE WILD BOYS	M
HELEN SHAPIRO	F
HELENE FISCHER	F
HELLO	M
HELLOGOODBYE	M
HENRY MANCINI	M
HEPBURN	M
HERB ALPERT	M
HERBIE GOINS & THE NIGHTIMERS	M
HERBIE HANCOCK	M
HERD	M
HERMAN'S HERMITS	M
HEROES DEL SILENCIO	M
HI-FI'S	M
HIGHWAYMEN	M
HILARY DUFF	F
HILLSIDERS	M
HILLTOPPERS	M
HINTERLAND	M
HIT PACK	M
HOLLIE COOK	F
HOLLIES	M
HOLLY HUMBERSTONE	F
HOLLY JOHNSON	M
HOLLY VALANCE	M
HOLLYWOOD BEYOND	M
HOLYCHILD	M
HOMBRES	M
HONEY CONE	M
HONEYBUS	M
HONEYCOMBS	F
HONEYDRIPPERS	M
HONEYZ	M
HOOBASTANK	M
HOOSIERS	M
HOOTERS	M
HOOTIE AND THE BLOWFISH	M
HOPETON LEWIS	M
HORST JANKOWSKI	M
HOT BUTTER	M
HOT CHOCOLATE	M
HOTHOUSE FLOWERS	M
HOUSE OF LOVE	M
HOUSEMARTINS	M
HOWARD CROCKETT	M
HOWARD JONES	M
HUE & CRY	M
HUES CORPORATION	M
HUEY LEWIS AND THE NEWS	M
HUGH MALCOLM	M
HUGO MONTENEGRO	M
HULLABALOOS	M
HUMAN EXPRESSION	M
HUMAN LEAGUE	M
HUMBLE PIE	M
HURRICANE SMITH	M
HURTS	M
I AM KLOOT	M
IAN BROWN	M
IAN CAMPBELL FOLK GROUP	M
IAN DURY AND THE BLOCKHEADS	M
IAN HUNTER	M
ICEHOUSE	M
ICICLE WORKS	M
IDLEWILD	M
IGGY POP	M
IKE AND TINA TURNER	M/F
IKETTES	F
IMAGINATION	M
IMAGINE DRAGONS	M
IMAJIN	M
IMANY	M
IMPERIALS	M
IMPRESSIONS	M
INCANTATION	M
INCOGNITO	M
INDEEP	M
INEZ AND CHARLIE FOXX	M/F
INFORMATION SOCIETY	M
INNER CITY	M
INNOCENCE	M
INNONCENCE MISSION	M
INSPIRAL CARPETS	M
INTRUDERS	M
INXS	M
IPSO FACTO	M
IRENE CARA	F
IRIS WILLIAMS	M
IRON BUTTERFLY	M
ISAAC HAYES	M
ISIRTA	M
ISLEY BROTHERS	M
IT BITES	M
IT'S A BEAUTIFUL DAY	M
IT'S IMMATERIAL	M
IVY LEAGUE	M
IZZY BIZU	M
J GEILS BAND	M
J J CALE	M
J MATHIS AND D WILLIAMS	M
JACK BUCHANAN	M
JACK GARRATT	M
JACK JONES	M
JACK SAVORETTI	M
JACK SCOTT	M
JACKIE DESHANNON	F
JACKIE EDWARDS	F
JACKIE LEE	F
JACKIE LYNTON	F
JACKIE TRENT	F
JACKIE WILSON	F
JACKSON 5	M
JACKSON BROWNE	M
JACKSONS	M
JACOBS ZING	M
JAGS	M
JAGUARS	M
JAKE BUGG	M
JAKI GRAHAM	F
JAM	M
JAMES	M
JAMES AND BOBBY PURIFY	M
JAMES BLUNT	M
JAMES BROWN	M
JAMES BROWN AND THE FAMOUS FLAMES	M
JAMES INGRAM AND MICHAEL MCDONALD	M
JAMES MORRISON	M
JAMES TAYLOR	M
JAMIE CULLEN	M
JAMIROQUAI	M
JAN AND DEAN	M
JAN HAMMER	M
JAN WAYNE	M
JANE MORGAN	F
JANE WIEDLIN	F
JANE'S ADDICTION	F
JANET JACKSON	F
JANIS IAN	F
JANIS JOPLIN	F
JAPAN	M
JASON DERÜLO	M
JASON DONOVAN	M
JASON MRAZ	M
JAY & THE AMERICANS	M
JAYDEE	M
JAYHAWKS	M
JAZZMASTERS	M
JC STEWART	M
JEANNIE C. RILEY	F
JEANNIE SEELY	F
JEFF BECK	M
JEFF HEALEY	M
JEFFERSON AIRPLANE	M
JEFFERSON STARSHIP	M
JEFFREY OSBORNE	M
JELLYBEAN & ADELE BERTEI	M
JELLYBEAN & ELISA FIORILLO	M
JEM	M
JENN	M
JENNIFER LOPEZ	F
JENNIFER PAIGE	F
JENNIFER RUSH	F
JENNIFER WARNES	F
JERMAINE JACKSON	F
JERMAINE JACKSON & PIA ZADORA	M/F
JERMAINE STEWART	M
JERRY BUTLER	M
JERRY BUTLER & THE IMPRESSIONS	M
JERRY JEFF WALKER	M
JERRY KELLER	M
JERRY LEE LEWIS	M
JERRY WALLACE	M
JESS GLYNNE	F
JESSIE WARE	F
JESUS JONES	M
JET HARRIS & TONY MEEHAN	M
JETHRO TOE AKA TULL	M
JETHRO TULL	M
JETS	M
JEWEL AKENS	M
JILL DAY	F
JIM CAPALDI	M
JIM CROCE	M
JIM DALE	M
JIM DIAMOND	M
JIM GILSTRAP	M
JIM PARKER	M
JIM REEVES	M
JIM STAFFORD	M
JIM STEINMAN	M
JIM WHITE	M
JIMI HENDRIX	M
JIMMIE RODGERS	M
JIMMY BUFFETT	M
JIMMY CLANTON	M
JIMMY CLIFF	M
JIMMY HELMS	M
JIMMY HOLIDAY	M
JIMMY JAMES & THE VAGABONDS	M
JIMMY JONES	M
JIMMY JUSTICE	M
JIMMY MCGRIFF	M
JIMMY NAIL	M
JIMMY PARKINSON	M
JIMMY POWELL & THE FIFTH DIMENSION	M
JIMMY RUFFIN	M
JIMMY SMITH	M
JIMMY SOMERVILLE	M
JIMMY SOMERVILLE FEAT. JUNE MILES-KINGSTON	M/F
JIMMY SOUL	M
JIMMY YOUNG	M
JIMOTHY LACOSTE	M
JJ CALE	M
JLS	M
JO DEE MESSINA	F
JO JO GUNNE	M
JO STAFFORD	F
JOAN ARMATRADING	F
JOAN BAEZ	F
JOAN OSBORNE	F
JOAN REGAN	F
JOBOXERS	M
JOCELYN BROWN	F
JODY WATLEY	F
JOE & JAKE	M
JOE BROWN	M
JOE BROWN & THE BRUVVERS	M
JOE COCKER	M
JOE COCKER & JENNIFER WARNES	M
JOE DOLAN	M
JOE JACKSON	M
JOE LOSS ORCHESTRA	M
JOE MCELDERRY	M
JOE SATRIANI	M
JOE SIMON	M
JOE SMOOTH	M
JOE SOUTH	M
JOE TEX	M
JOE WALSH	M
JOEY GRACEFFA	M
JOEY GRACEFFA & LUKE CONARD	M
JOHN BARRY	M
JOHN BARRY SEVEN PLUS FOUR	M
JOHN COLLIER	M
JOHN COOPER CLARKE	M
JOHN COUGAR	M
JOHN DENVER	M
JOHN FARNHAM	M
JOHN FOXX	M
JOHN FRED AND HIS PLAYBOY BAND	M
JOHN LEE HOOKER	M
JOHN LENNON	M
JOHN LENNON AND PLASTIC ONO BAND	M
JOHN LEYTON AND THE LEROYS	M
JOHN MAYALL AND THE BLUESBREAKERS	M
JOHN MELLENCAMP	M
JOHN MILES	M
JOHN PARR	M
JOHN SCHROEDER ORCHESTRA	M
JOHN SEBASTIAN	M
JOHN STEWART	M
JOHN WAITE	M
JOHN WALKER	M
JOHN WEST	M
JOHN WILLIAMS	M
JOHNNIE RAY	M
JOHNNIE WALKER	M
JOHNNY & THE HURRICANES	M
JOHNNY BURNETTE	M
JOHNNY CASH	M
JOHNNY CLEGG & SAVUKA	M
JOHNNY CORPORATE	M
JOHNNY DANKWORTH	M
JOHNNY HATES JAZZ	M
JOHNNY JOHNSON & THE BANDWAGON	M
JOHNNY KIDD & THE PIRATES	M
JOHNNY LOGAN	M
JOHNNY MATHIS	M
JOHNNY MATHIS & DENIECE WILLIAMS	M
JOHNNY NASH	M
JOHNNY OTIS	M
JOHNNY OTIS SHOW	M
JOHNNY PRESTON	M
JOHNNY RIVERS	M
JOHNNY TILLOTSON	M
JOHNNY WAKELIN	M
JOHNNY WINTER	M
JOHNNY YOUNG	M
JOHNNY YOUNG & KOMPANY	M
JON & VANGELIS	M
JON BON JOVI	M
JON SECADA	M
JONA LEWIE	M
JONATHAN BUTLER	M
JONATHAN EDWARDS	M
JONATHAN KING	M
JONATHAN RICHMAN	M
JORG ZIMMER	M
JOSE FELICIANO	M
JOSEPH	M
JOSH RITTER	M
JOSH ROUSE	M
JOSHUA KADISON	M
JOSHUA RADIN	M
JOURNEY	M
JOY DIVISION	M
JOYCE SIMS	F
JOYCE'S ANGELS	F
JR. WALKER & THE ALL STARS	M
JUBËL	M
JUDAS PRIEST	M
JUDE COLE	M
JUDGE DREAD	M
JUDIE TZUKE	F
JUDY COLLINS	F
JUDY GARLAND	F
JUDY STREET	F
JUICE NEWTON	M
JUICY LUCY	M
JULEE CRUISE	F
JULIA AND COMPANY	F
JULIA FORDHAM	F
JULIAN COPE	M
JULIAN LENNON	M
JULIE DRISCOLL & BRIAN AUGER & THE TRINITY	M/F
JULIE FELIX	F
JULIE GRANT	F
JULIE LONDON	F
JULIE ROGERS	F
JULIET TURNER	F
JUNE CHRISTY	F
JUNIOR	M
JUNIOR JACK	M
JUNIOR SENIOR	M
JUSTIN	M
JUSTIN BIEBER	M
JUSTIN HAYWARD	M
JUSTINE WASHINGTON	M
JUVENTA	M
K D LANG	F
K-CI AND JOJO	M
KAISER CHIEFS	M
KAJAGOOGOO	M
KALIN TWINS	M
KALITWOOZ	M
KANDI	M
KANE GANG	M
KANSAS	M
KAOMA	M
KAREL FIALKA	M
KAREN RAMIREZ	F
KAREN VERROS	F
KARL DENVER TRIO	M
KATE BUSH	F
KATE BUSH & PETER GABRIEL	M/F
KATE ROBBINS	F
KATHY KIRBY	F
KATIE MELUA	F
KATRINA & THE WAVES	F
KATY PERRY	F
KAVANA	M
KAY STARR	M
KC & THE SUNSHINE BAND	M
KEANE	M
KEITH	M
KEITH & TEX	M
KEITH MARSHALL	M
KEITH POWELL & THE VALETS	M
KEITH SWEAT	M
KEITH URBAN	M
KEITH WEST	M
KELE LE ROC	M
KELLY MARIE	F
KEN BRUCE	M
KEN DODD	M
KEN THORNE & HIS ORCHESTRA	M
KENDEL CARSON	F
KENI BURKE	M
KENNY	M
KENNY G	M
KENNY LOGGINS	M
KENNY LYNCH	M
KENNY ROGERS	M
KENNY ROGERS & SHEENA EASTON	M/F
KENNY ROGERS & THE FIRST EDITION	M
KETTY LESTER	F
KID CREOLE & THE COCONUTS	M
KIDS FROM FAME	M
KIDS IN GLASS HOUSES	M
KIKI DEE	F
KILLERS	M
KILLING JOKE	M
KIM APPELBY	F
KIM CARNES	F
KIM WESTON	F
KIM WILDE	F
KINCADE	M
KING	M
KING BROTHERS	M
KING CURTIS	M
KINGDOM COME	M
KINGS OF CONVENIENCE	M
KINGS OF LEON	M
KINGS SINGERS	M
KINGSMEN	M
KINGSTON TRIO	M
KINGSTONIANS	M
KINKS	M
KIRSTY MACCOLL	F
KISS	M
KISSING THE PINK	M
KITCHENS OF DISTINCTION	M
KLEERUP	M
KLF	M
KLF FEAT. THE CHILDREN OF THE REVOLUTION	M
KNACK	M
KNICKERBOCKERS	M
KODALINE	M
KON KAN	M
KOOBAS	M
KOOKS	M
KOOL & THE GANG	M
KOOL AND THE GANG	M
KORGIS	M
KRAFTWERK	M
KRIS KRISTOFFERSON	M
KRISTIAN LEONTIOU	M
KRUSH	M
KT TUNSTALL	F
KUBB	M
KULA SHAKER	M
KURSAAL FLYERS	M
KURTIS BLOW	M
KWS	M
KYLE FALCONER	M
KYLIE MINOGUE	F
KYM MARSH	F
KYM MAZELLE	F
KYM SIMS	F
KYU SAKAMOTO	M
L7	M
LA'S	M
LABI SIFFRE	M
LADY ANTEBELLUM	F
LAID BACK	M
LAKE	M
LALAH HATHAWAY	F
LAMBCHOP	M
LANA SISTERS	F
LANDSCAPE	M
LARRY WILLIAMS	M
LATIN QUARTER	M
LAURA BRANIGAN	F
LAURA NYRO	F
LAURIE JOHNSON ORCHESTRA	M
LAURIE LONDON	M
LAWSON	M
LAYLA KAYLIF	F
LEANN RIMES	F
LEAVES	M
LED ZEPPELIN	M
LEE (SCRATCH) PERRY	M
LEE ANN WOMACK	F
LEE CLAYTON	M
LEE DAVID	M
LEE DORSEY	M
LEE GREENWOOD	M
LEE LAWRENCE	M
LEE MEAD	M
LEE RYAN	M
LEMON PIPERS	M
LEMONHEADS	M
LEN	M
LEN BARRY	M
LENE LOVICH	F
LENE MARLIN	F
LENNY KRAVITZ	M
LENNY WELCH	M
LEO SAYER	M
LEONIE PERNET	M
LEROY PULLINS	M
LEROY VAN DYKE	M
LES BAXTER	M
LES CRANE	M
LES DAWSON	M
LES PAUL & MARY FORD	M
LESLEY DUNCAN	F
LESLEY GORE	F
LET LOOSE	M
LETTERMEN	M
LEVEL 42	M
LEVELLERS	M
LEVELS	M
LEVERT	M
LEWIS SISTERS	F
LIBERTY X	M
LIEUTENANT PIGEON	M
LIGHT OF THE WORLD	M
LIGHTHOUSE FAMILY	M
LIGHTNING SEEDS	M
LIMAHL	M
LIMIT	M
LINDA CARR & THE LOVE SQUAD	M/F
LINDA LEWIS	F
LINDA RONSTADT	F
LINDA RONSTADT & JAMES INGRAM	M/F
LINDA RONSTADT FEAT. AARON NEVILLE	M/F
LINDISFARNE	M
LINDSEY BUCKINGHAM	M
LINDSEY BUCKINGHAM & CHRISTINE MCVIE	M/F
LINDY LAYTON	F
LINK CROMWELL	M
LINK WRAY	M
LINK WRAY & HIS RAY MEN	M
LINX	M
LIONEL RICHIE	M
LIPPS INC	M
LISA LOEB	F
LISA STANSFIELD	F
LISSIE	F
LITTLE ANGELS	M
LITTLE ANTHONY AND THE IMPERIALS	M
LITTLE EVA	F
LITTLE FEAT	M
LITTLE HANK	M
LITTLE JIMMY OSMOND	M
LITTLE LISA	F
LITTLE RICHARD	M
LITTLE RIVER BAND	M
LIVERPOOL EXPRESS	M
LIVIN' JOY	M
LIVING COLOUR	M
LIVING IN A BOX	M
LIVING WITH THE ENEMY	M
LIZA MINNELLI	F
LL COOL J	M
LLOYD COLE AND THE COMMOTIONS	M
LLOYD PRICE	M
LOBO	M
LOGGINS & MESSINA	M
LOLA LENNOX	F
LONDON GRAMMAR	M
LONDON MODEL ACADEMY	M
LONE JUSTICE	M
LONESTAR	M
LONG HOT SATSUMA	M
LONG JOHN BALDRY	M
LONG TALL ERNIE AND THE SHAKERS	M
LONG VIEW	M
LONNIE DONEGAN	M
LOOK	M
LOOSE ENDS	M
LOOT	M
LORD ROCKINGHAMS XLL	M
LORNE GREEN	M
LORRAINE ELLISON	F
LOS BRAVOS	M
LOS CANARIOS	M
LOS DEL RÍO	M
LOS LOBOS	M
LOTUS EATERS	M
LOU BEGA	M
LOU BUSCH & HIS ORCHESTRA	M
LOU CHRISTIE	M
LOU GRAMM	M
LOU JOHNSON	M
LOU RAWLS	M
LOU REED	M
LOUDON WAINWRIGHT 111	M
LOUIS ARMSTRONG	M
LOUIS ARMSTRONG & THE ALL STARS	M
LOUIS PRIMA & KEELY SMITH	M
LOUISE	F
LOVE	M
LOVE & ROCKETS	M
LOVE AFFAIR	M
LOVE GENERATION	M
LOVE INC.	M
LOVE SCULPTURE	M
LOVE UNLIMITED	M
LOVERBOY	M
LOVIN' SPOONFUL	M
LOVING AWARENESS	M
LUCIANO PAVAROTTI & PASSENGERS	M
LUCIE SILVAS	F
LUCINDA WILLIAMS	F
LUKE CONARD & JOEY GRACEFFA	M
LULU	F
LUSH	M
LUTHER VANDROSS	M
LUTRICIA MCNEAL	F
LUV	M
LYKKE LI	F
LYNDEN DAVID HALL	M
LYNNE RANDALL	F
LYNSEY DE PAUL	F
LYNYRD SKYNYRD	M
M	M
M PEOPLE	M/F
M.A.R.R.S	M
M/A/R/R/S	M
MADHOUSE	M
MADNESS	M
MADONNA	F
MAGIC LANTERNS	M
MAGIC NUMBERS	M
MAGNA CARTA	M
MAGNUM	M
MAI TAI	M
MAIRE BRENNAN	M
MALCOLM MCLAREN	M
MALCOLM VAUGHAN	M
MAMA CASS	F
MAMA'S BOYS	M
MAMAS AND THE PAPAS	M/F
MANFRED MANN	M
MANFRED MANN'S EARTHBAND	M
MANHATTANS	M
MANIC STREET PREACHERS	M
MANOWAR	M
MANSUN	M
MANTOVANI AND HIS ORCHESTRA	M
MANTRONIX	M
MAR-KEYS	M
MARBLES	M
MARC ALMOND	M
MARC ALMOND AND GENE PITNEY	M
MARC BOLAN	M
MARC COHN	M
MARCELLA DETROIT	F
MARCELS	M
MARCIA RAVEN	M
MARCIE BLANE	M
MARGARET URLICH	F
MARI WILSON	F
MARIA MCKEE	F
MARIA MULDAUR	F
MARIA VIDAL	F
MARIAH CAREY	F
MARIANNE FAITHFULL	F
MARIE OSMOND	F
MARILLION	M
MARILYN	F
MARINO	M
MARION	M
MARION RYAN	F
MARIONETTES	M
MARK JOSEPH	M
MARK KNOPFLER	M
MARK MORRISON	M
MARK OWEN	M
MARK WYNTER	M
MARMALADE	M
MAROON 5	M
MARSHALL HAIN	M
MARSHALL JEFFERSON	M
MARSHMELLO AND BASTILLE	M
MARSHMELLO AND DEMI LOVATO	M
MARSHMELLO AND JONAS BROTHERS	M
MARSHMELLO AND SELENA GOMEZ	M
MARSHMELLO FT KHALID	M
MARTHA AND THE MUFFINS	M
MARTHA REEVES	F
MARTHA REEVES AND THE VANDELLAS	F
MARTIKA	F
MARTIN GARRIX	M
MARTINE MCCUTCHEON	F
MARTY ROBBINS	M
MARTY WILDE	M
MARV JOHNSON	M
MARV JOHNSTON	M
MARVELETTES	M
MARVIN AND TAMARA	M
MARVIN GAYE	M
MARVIN GAYE AND TAMMI TERRELL	M
MARY J BLIGE	F
MARY JANE GIRLS	F
MARY WELLS	F
MASSIVE ATTACK	M
MASTERMINDS	M
MATT BIANCO	M
MATT CARDLE	M
MATT MONRO	M
MATTHEW MARSDEN	M
MATTHEW WILDER	M
MATTHEWS SOUTHERN COMFORT	M
MAUREEN EVANS	F
MAUREEN MCGOVERN	F
MAVERICKS	M
MAX BYGRAVES	M
MAX GEORGE	M
MAX JURY	M
MAXI PRIEST	M
MAYTALS	M
MAZE; FRANKIE BEVERLY	M
MC HAMMER	M
MC MIKER G. & DJ SEVEN	M
MCALMONT & BUTLER	M
MCCOYS	M
MCFADDEN AND WHITEHEAD	M
MCFLY	M
MCFLY & TAIO CRUZ	M
MCGANNS	M
MCGUINNESS FLINT	M
MCGUIRE SISTERS	M
MEAT LOAF	M
MEAT LOAF WITH CHER	M/F
MEDICINE HEAD	M
MEDUSA AFRO	M
MEL & KIM	F
MEL TORME	M
MELANIE	F
MELANIE C	F
MELBA MOORE	F
MELEE	F
MELLOTONES	M
MELODIANS	M
MEN AT WORK	M
MEN WITHOUT HATS	M
MENTAL AS ANYTHING	M
MEREDITH BROOKS	M
MERRILEE RUSH	F
MERSEYBEATS	M
MERSEYS	M
MIAMI SOUND MACHINE	M
MICA PARIS	F
MICA PARIS & WILL DOWNING	M/F
MICHAEL ANDREWS FEAT. GARY JULES	M
MICHAEL BADAL ZYA & TEDDY C	M
MICHAEL BALL	M
MICHAEL BOLTON	M
MICHAEL BUBLE	M
MICHAEL DAVIDSON	M
MICHAEL HOLIDAY	M
MICHAEL HOLLIDAY	M
MICHAEL JACKSON	M
MICHAEL MCDONALD	M
MICHAEL PENN	M
MICHAEL SEMBELLO	M
MICHAEL ZAGER BAND	M
MICK JAGGER & DAVE STEWART	M
MICK JAGGER AND MICHAEL JACKSON	M
MICKEY & SYLVIA	M/F
MIDGE URE	M
MIDNIGHT OIL	M
MIDNIGHT STAR	M
MIGHTY WAH	M
MIGIL 5	M
MIKA	M
MIKE AND THE MECHANICS	M
MIKE BERRY	M
MIKE OLDFIELD	M
MIKE PATTO	M
MIKE POST	M
MIKE RABIN AND THE DEMONS	M
MIKE SARNE	M
MILEY CYRUS	F
MILLI VANILLI	M
MILLIE	F
MINDBENDERS	M
MINK DE VILLE	M
MINNIE RIPERTON	F
MIRACLES	M
MISHKA	M
MISSION	M
MITCH RYDER AND THE DETROIT WHEELS	M
MOBY	M
MOCK TURTLES	M
MODERN ROMANCE	M
MODERN TALKING	M
MODEST MOUSE	M
MODJO	M
MOFFATTS	M
MOJOS	M
MOLLY HATCHET	M
MOLOKO	M
MOMENTS	M
MONACO	M
MONITORS	M
MONKEES	M
MONOPOLY	M
MONOTONES	M
MONSOON	M
MONSTERS OF FOLK	M
MONTANAS	M
MOOD MOSAIC	M
MOODY BLUES	M
MOON MARTIN	M
MOONY	M
MORRIS ALBERT	M
MORRISSEY	M
MOSES	M
MOTELS	M
MOTORHEAD	M
MOTORS	M
MOTT THE HOOPLE	M
MOUNTAIN	M
MOVE	M
MR BIG	M
MR BLOE	M
MR MISTER	M
MR. BIG	M
MR. FINGERS	M
MUD	M
MUDLARKS	M
MUNGO JERRY	M
MURRAY HEAD	M
MUSE	M
MUSICAL YOUTH	M/F
NAKED EYES	M
NANA MOUSKOURI	F
NANCI GRIFFITH	F
NANCY SINATRA	F
NANCY SINATRA & LEE HAZLEWOOD	M/F
NANCY SINATRA AND LEE HAZLEWOOD	M/F
NANCY WILSON	F
NAPOLEON XIV	M
NARADA MICHAEL WALDEN	M
NASHVILLE TEENS	M
NAT KING COLE	M
NATALIE COLE	F
NATALIE GRANT	F
NATASHA BEDINGFIELD	F
NATURALS	M
NAVY	M
NAZARETH	M
NED MILLER	M
NEIL CHRISTIAN	M
NEIL DIAMOND	M
NEIL FINN	M
NEIL SEDAKA	M
NEIL YOUNG	M
NELLY	F
NELLY FURTADO	M
NENA	F
NENEH CHERRY	F
NEW ATLANTIC	M
NEW EDITION	M
NEW KIDS ON THE BLOCK	M
NEW MODEL ARMY	M
NEW MUSIK	M
NEW ORDER	M
NEW RADICALS	M
NEW RIDERS OF THE PURPLE SAGE	M
NEW SEEKERS FEAT. LYN PAUL	M/F
NEW VAUDEVILLE BAND	M
NEW YORK CITY	M
NEW YORK DOLLS	M
NEW YORK PUBLIC LIBRARY	M
NEWBEATS	M
NEWTON FAULKNER	M
NEXT	M
NIALL HORAN	M
NIALL HORAN AND ANNE-MARIE	M/F
NICE	M
NICK HEYWARD	M
NICK KAMEN	M
NICK STRAKER BAND	M
NICKEL CREEK	M
NICOLE	F
NIGHT RANGER	M
NIK KERSHAW	M
NILS LOFGREN	M
NILSSON	M
NINA SIMONE	F
NINO TEMPO	M
NINO TEMPO & APRIL STEVENS	M/F
NINO TEMPO AND APRIL STEVENS	M/F
NIRVANA	M
NITTY GRITTY DIRT BAND	M
NO DOUBT	M
NO MERCY	M
NOAH AND THE WHALE	M
NOEL GALLAGHER'S HIGH FLYING BIRDS	M
NOLANS	M/F
NOLEN AND CROSSLEY	M/F
NOMAD	M
NORAH JONES	F
NORMA TANEGA	F
NORMALITES	M
NORMAN COOK	M
NORMAN GREENBAUM	M
NORMAN WISDOM	M
NORRIE PARAMOR	M
NOVAS	M
NU SHOOZ	M
O'BRIEN BROTHERS	M
O'JAYS	M
O.C. SMITH	M
OASIS	M
OCEAN	M
OCEAN COLOUR SCENE	M
ODIN'S PEOPLE	M
ODYSSEY	M
OH WELL	M
OHIO EXPRESS	M
OLD HARRYS GAME	M
OLETA ADAMS	F
OLIVER	M
OLLIE AND JERRY	M
OLLY MURS	M
OLYMPICS	M
OMC	M
OMD	M
ONE 2 MANY	M
ONE DIRECTION	M
ONE TRUE VOICE	M
ONEREPUBLIC	M
ONLY ONES	M
OPUS	M
OPUS III	M
ORANGE JUICE	M
ORB	M
ORBITAL	M
ORDINARY BOYS	M
ORIOLES	M
ORLEANS	M
ORSON	M
OSIBISA	M
OSMONDS	M
OTHER ONES	M
OTIS REDDING	M
OTT	M
OUR DAUGHTERS WEDDING	M
OUTKAST	M
OUTLAWS	M
OVERLANDERS	M
OWEN PAUL	M
OWL CITY	M
OXFORD CIRCLE	M
P J PROBY	M
P P ARNOLD	F
P!NK	M
PAGEBOYS	M
PANTERA	M
PAOLO NUTINI	M
PAPER DOLLS	M
PARAGONS	M
PARAMOUNTS	M
PASADENAS	M
PASSIONS	M
PAT BENATAR	F
PAT BOONE	M
PATO BANTON FEAT. ALI AND ROBIN CAMPBELL	M
PATRICE RUSHEN	F
PATRICK COWLEY FEAT. SYLVESTER	M
PATRICK WATSON	M
PATRIZIO BUANNE	M
PATSY CLINE	F
PATTI AUSTIN & JAMES INGRAM	M/F
PATTI LABELLE	F
PATTI LABELLE & MICHAEL MCDONALD	M/F
PATTI SMITH GROUP	F
PATTY SMYTH	F
PAUL AND BARRY RYAN	M
PAUL AND PAULA	M/F
PAUL AND RITCHIE AND THE CRYING SHAMES	M/F
PAUL ANKA	M
PAUL BRADY	M
PAUL BUTTERFIELD BLUES BAND	M
PAUL CARRACK	M
PAUL DAVIS	M
PAUL EVANS AND THE CURLS	M
PAUL HARDCASTLE	M
PAUL JONES	M
PAUL MCCARTNEY	M
PAUL MCCARTNEY AND MICHAEL JACKSON	M
PAUL MCCARTNEY AND STEVIE WONDER	M
PAUL MCCARTNEY AND WINGS	M
PAUL NORTON	M
PAUL PETERSEN	M
PAUL REVERE AND THE RAIDERS	M
PAUL SIMON	M
PAUL VAN DYK	M
PAUL WELLER	M
PAUL YOUNG	M
PAULA ABDUL	F
PAULA COLE	F
PAULINE BLACK OF THE SELECTOR	F
PAULINE HENRY	F
PEABO BRYSON & ROBERTA FLACK	M
PEACHES AND HERB	M
PEBBLES	F
PEGGY LEE	F
PENGUINS	M
PEPSI AND SHIRLIE	F
PERCY FAITH	M
PERCY SLEDGE	M
PEREZ PRADO	M
PEREZ PRADO FEAT. ROSEMARY CLOONEY	M/F
PERRY COMO	M
PERSONNA	M
PET SHOP BOYS	M
PET SHOP BOYS AND EIGHTH WONDER	M
PETE BEST FOUR	M
PETE SEEGER	M
PETE TOWNSHEND	M
PETE WYLIE	M
PETER AND GORDON	M
PETER ANDRE	M
PETER BRUNTNELL	M
PETER CETERA	M
PETER FRAMPTON	M
PETER GABRIEL	M
PETER GREEN	M
PETER LEE STIRLING	M
PETER PAUL & MARY	M/F
PETER SARSTEDT	M
PETER SCHILLING	M
PETER TOSH	M
PETERS AND LEE	M/F
PETTICOAT	F
PETULA CLARK	F
PHATS & SMALL	M
PHATS AND SMALL	M
PHD	M
PHIL CARMEN	M
PHIL COLLINS	M
PHIL FEARON & GALAXY	M
PHIL PHILLIPS	M
PHIL PHILLIPS AND THE TWILIGHTS	M
PHIL SPECTOR	M
PHIL UPCHURCH COMBO	M
PHILIP BAILEY	M
PHILLIP LYNOTT	M
PHIXX	M
PHYLLIS NELSON	F
PIANOMAN	M
PICKETTYWITCH	M/F
PIGLETS	M
PILOT	M
PINK	M
PINK FLOYD	M
PINKEES	M
PINKERTON'S ASSORTED COLOURS	M
PINKERTON'S COLOURS	M
PINKERTONS ASSORTED COLOURS	M
PIONEERS	M
PIPKINS	M
PIZZAMAN	M
PJ PROBY	M
PLAIN WHITE T'S	M
PLANET FUNK	M
PLANET PERFECTO FEAT. GRACE	M
PLASTIC BERTRAND	M
PLATTERS	M
PLAYER	M
PLUMB	M
PM DAWN	M
POCO	M
POETS	M
POETS (US)	M
POGUES & KIRSTY MACCOLL	M/F
POINT BREAK	M
POINTER SISTERS	F
POISON	M
POLARKREIS 18	M
POLICE	M
PONI TAILS	F
PONI-TAILS	F
PONY	M
POP WILL EAT ITSELF	M
POWER STATION	M
POWERHOUSE FEAT. DUANE HARDEN	M
PRECIOUS	M
PREFAB SPROUT	M
PRELUDE	M
PRETENDERS	M
PRETTY THINGS	M
PRIMAL SCREAM	M
PRIMITIVES	M
PRINCE	M
PROCLAIMERS	M
PROCOL HARUM	M
PRODIGY	M
PROPAGANDA	M
PSEUDO ECHO	M
PSYCHEDELIC FURS	M
PUBLIC IMAGE LTD	M
PUFF DADDY	M
PULP	M
PUPPINI SISTERS	F
PURPLE GANG	M
PYTHON LEE JACKSON	M
QUARTERFLASH	M
QUARTZ & DINA CARROLL	M/F
QUEEN	M
QUEEN & DAVID BOWIE	M
QUESTION MARK AND THE MYSTERIANS	M
QUICKSILVER MESSENGER SERVICE	M
QUIET RIOT	M
QUINCY JONES	M
QUIREBOYS	M
R DEAN TAYLOR	M
R KELLY	M
R. B. GREAVES	M
R.B.A.	M
R.E.M	M
RACEY	M
RACHEL STEVENS	F
RACING CARS	M
RADIOHEAD	M
RAGE	M
RAH BAND	M
RAILWAY CHILDREN	M
RAINBOW	M
RAINMAKERS	M
RAINY DAZE	M
RALPH MCTELL	M
RALPH TRESVANT	M
RAM JAM	M
RAMONES	M
RANDY CRAWFORD	F
RANDY EDELMAN	M
RANDY NEWMAN	M
RANDY VANWARMER	M
RANG-A-TANG UNCOVERED	M
RARE BIRD	M
RASCALS	M
RATT	M
RAY ANTHONY	M
RAY CHARLES	M
RAY ELLINGTON QUARTET	M
RAY LAMONTAGNE	M
RAY MARTIN	M
RAY MOORE	M
RAY PARKER JR	M
RAY PETERSON	M
RAY RUFF & THE CHECKMATES	M
RAY SHARPE	M
RAY STEVENS	M
RAYDIO	M
RAZE	M
RAZORLIGHT	M
RE-FLEX	M
REAL THING	M
RED BOX	M
RED HOT CHILI PEPPERS	M
REDCAPS	M
REEF	M
REINDEER SECTION	M
REM	M
REMBRANDTS	M
RENAISSANCE	M
RENE AND ANGELA	M/F
RENEE AND RENATO	M/F
REO SPEEDWAGON	M
REPARATA & THE DELRONS	F
REPUBLICA	M
REVELATIONS	M
REX GARVIN	M
RIC OCASEK	M
RICHARD ANTHONY	M
RICHARD ASHCROFT	M
RICHARD DURAND	M
RICHARD HAWLEY	M
RICHARD HUDNUT	M
RICHARD JON SMITH	M
RICHARD MARX	M
RICHE	M
RICHIE BARRETT	M
RICK ASTLEY	M
RICK JAMES	M
RICK JAMES & TEENA MARIE	M/F
RICK NELSON	M
RICK SPRINGFIELD	M
RICKIE LEE JONES	M
RICKY DILLON	M
RICKY MARTIN	M
RICKY NELSON	M
RICKY VALANCE	M
RIGHEIRA	M
RIGHT SAID FRED	M
RIGHTEOUS BROTHERS	M
RITA COOLIDGE	F
RITA PAVONE	F
RITCHIE VALENS	M
RITON & OLIVER HELDENS	M
RIVER CITY PEOPLE	M
ROACHFORD	M
ROARING SIXTIES	M
ROBBIE NEVIL	M
ROBBIE ROBERTSON	M
ROBBIE WILLIAMS	M
ROBERT HOWARD & KYM MAZELLE	M/F
ROBERT JOHN	M
ROBERT KNIGHT	M
ROBERT MILES. FEAT MARIA NAYLOR	M/F
ROBERT PALMER	M
ROBERT PARKER	M
ROBERT PLANT	M
ROBERT PLANT & ALISON KRAUSS	M/F
ROBERT POST	M
ROBERTA FLACK & PEABO BRYSON	M/F
ROBERTA FLACK AND DONNY HATHAWAY	M/F
ROBIN BECK	M
ROBIN GIBB	M
ROBIN TROWER	M
ROBYN	F
ROCK STEADY CREW	M
ROCKERS REVENGE	M
ROCKERS REVENGE FT. DONNIE CA	M
ROCKIN' BERRIES	M
ROCKIN' VICKERS	M
ROCKWELL	M
ROCKY BURNETTE	M
ROCOCO	M
ROD STEWART	M
ROD STEWART AND RONAL ISLEY	M
ROD STEWART AND THE FACES	M
ROGER DALTREY	M
ROGER MILLER	M
ROGER ROYLE	M
ROGER SANCHEZ	M
ROGER WHITTAKER	M
ROLF HARRIS	M
ROLLING STONES	M
ROMANTICS	M
ROMEO	M
ROMEO & THE EMOTIONS	M
RON GRAINER	M
RONAN KEATING	M
RONAN KEATING & LEANN RIMES	M/F
RONETTES	F
RONNIE HILTON	M
ROOFTOP SINGERS	M
ROOM 5 FEAT. OLIVER CHEATHAM	M
ROOSTERS	M
RORY GALLAGHER	M
ROSANNE CASH	F
ROSE ROYCE	F
ROSEMARY CLOONEY	F
ROSS HANNAMAN	M
ROTARY CONNECTION	M
ROTHCHILDS	M
ROUEN	M
ROULETTES	M
ROXETTE	M/F
ROXY MUSIC	M
ROY HEAD	M
ROY ORBISON	M
ROY SHIRLEY	M
ROY WOOD AND WIZZARD	M
ROYKSOPP	M
ROZALLA	F
RUBETTES	M
RUBY & THE ROMANTICS	F
RUBY AND THE ROMANTICS	F
RUBY MURRAY	F
RUBY TURNER	F
RUDY MILLS	F
RUFF DRIVERZ PRESENTS ARROLA	M
RUFUS AND CHAKA KHAN	M/F
RUFUS THOMAS	M
RUI DA SILVA	M
RUN DMC	M
RUN DMC VS JASON NEVINS	M
RUN DMC WITH AEROSMITH	M
RUNAWAY	M
RUNRIG	M
RUPERT HOLMES	M
RUSH	M
RUSS BALLARD	M
RUSS CONWAY	M
RUSS HAMILTON	M
RUTH BROWN	F
RY COODER	M
RYAN ADAMS	M
RYAN PARIS	M
RYANDAN	M
RYCOL	M
S CLUB 7	M
S'EXPRESS	M
S.O.S BAND	M
SABRINA	F
SACRED SPIRIT	M
SAD CAFE	M
SADE	F
SAFRI DUO	M
SAGA	M
SAILCAT	M
SAILOR	M
SAINT ETIENNE	M
SALENA JONES	M
SALLY OLDFIELD	F
SALT-N-PEPA	F
SAM AND DAVE	M
SAM AND MARK	M
SAM BROWN	F
SAM COOKE	M
SAM FENDER	M
SAM THE SHAM AND THE PHAROAHS	M
SAMANTHA FOX	F
SAMANTHA MUMBA	F
SAMMY DAVIS JR	M
SAN & WENDEL KOS	M
SAN REMO GOLDEN STRINGS	M
SANDI SHELDON	F
SANDIE SHAW	F
SANDPIPERS	M
SANDRA	F
SANDY B	M
SANDY POSEY	F
SANTA ESMERALDA	M
SANTANA	M
SARAH BRIGHTMAN	F
SARAH K	F
SARAH MCLACHLAN	F
SARAH'S CAROL SINGER	F
SASH	F
SASHA & EMERSON	F
SATURDAYS	M
SATURDAYS & FLO RIDA	M
SAVAGE GARDEN	M
SAXON	M
SAY LOU LOU	M
SCAFFOLD	M
SCARLET	M
SCARLET FANTASTIC	M
SCENT	M
SCISSOR SISTERS	F
SCORPIONS	M
SCOTT & LEON	M
SCOTT FITZGERALD & YVONNE KEELEY	M/F
SCOTT MCKENZIE	M
SCOTT WALKER	M
SCOUTING FOR GIRLS	M
SCREAMING TREES	M
SCRIPT	M
SCRITTI POLITTI	M
SEA WOLF	M
SEAL	M
SEALS & CROFTS	M
SEARCHERS	M
SEEDS	M
SEEKERS	M/F
SELECTER	M
SENSATIONS	M
SERGIO MENDES	M
SETTLERS	M
SEVENTHAVENUE	M
SHADOWS	M
SHADOWS OF KNIGHT	M
SHAGGY	M
SHAKATAK	M
SHAKATAK & AL JARREAU	M
SHAKESPEAR'S SISTER	F
SHAKIN' STEVENS	M
SHAKIRA	F
SHALAMAR	M
SHAMEN	M
SHANE FENTON & THE FENTONES	M
SHANGRI-LAS	F
SHANIA TWAIN	F
SHANICE	F
SHANKS & BIGFOOT	M
SHANNON	M
SHAPESHIFTERS	M
SHARI BELAFONTE	M
SHARLEEN SPITERI	F
SHARON CORR	F
SHARPE & NUMAN	M
SHAWN COLVIN	F
SHAWN MULLINS	M
SHAYNE WARD	M
SHE TRINITY	F
SHED SEVEN	M
SHEENA EASTON	F
SHEILA B DEVOTION	F
SHEILA E.	F
SHELBY FLINT	M
SHEPPARD	M
SHERBET	M
SHERRICK	M
SHERYL CROW	F
SHILHOUETTES	M
SHIRELLES	F
SHIRES	M
SHIRLEY & COMPANY	F
SHIRLEY BASSEY	F
SHIRLEY ELLIS	F
SHOCKING BLUE	M
SHOLA AMA	F
SHOTGUN EXPRESS	M
SHOWADDYWADDY	M
SHOWMEN	M
SHOWSTOPPERS	M
SIGALA & JAMES ARTHUR	M
SIGHT AND SOUND	M
SIGMA	M
SIGMA AND JACK SAVORETTI	M
SIGNS	M
SIGUE SIGUE SPUTNIK	M
SILENCE	M
SILKIE	M
SIMON AND GARFUNKEL	M
SIMON DUPREE AND THE BIG SOUND	M
SIMON PARK ORCHESTRA	M
SIMON SISTERS	F
SIMON WEBBE	M
SIMPLE KID	M
SIMPLE MINDS	M
SIMPLY RED	M
SINEAD LOHAN	F
SINEAD O'CONNOR	F
SINÉAD O'CONNOR	F
SIOUXSIE & THE BANSHEES	F
SIOUXSIE AND THE BANSHEES	F
SIR DOUGLAS QUINTET	M
SIR TERRY WOGAN	M
SISTER SLEDGE	F
SISTERS OF MERCY	F
SIXPENCE NONE THE RICHER	M
SKATALITES	M
SKEETER DAVIS	F
SKID ROW	M
SKIDS	M
SKIVERS	M
SKY ISLAND	M
SL2	M
SLADE	M
SLEEPER	M
SLIK	M
SLIM WHITMAN	M
SLY	M
SLY AND THE FAMILY STONE	M
SLY FOX	M
SMALL FACES	M
SMARTIES	M
SMITHS	M
SMOKE	M
SMOKEY ROBINSON	M
SMOKEY ROBINSON AND THE MIRACLES	M
SMOKIE	M
SNAP	M
SNIFF 'N' THE TEARS	M
SNOW PATROL	M
SNOWBALL	M
SNOWY WHITE	M
SODA CLUB	M
SOFT CELL	M
SOLOMON BURKE	M
SONICS	M
SONJA	F
SONNY AND CHER	M/F
SONS OF FRED	M
SOPHIE B HAWKINS	F
SOPHIE ELLIS BEXTOR	F
SORROWS	M
SOUL ASYLUM	M
SOUL II SOUL	M
SOUNDGARDEN	M
SOUNDS ORCHESTRAL	M
SOUP DRAGONS	M
SOURCE	M
SOURCE FEAT. CANDI STATON	M/F
SOUTHSIDE JOHNNY AND THE ASBURY JUKES	M
SPACE	M
SPACE COWBOY	M
SPADES	M
SPAGNA	M
SPANDAU BALLET	M
SPANKY AND OUR GANG	M
SPARKS	M
SPC	M
SPEAR OF DESTINY	M
SPECIAL AKA	M
SPECIALS	M
SPECTRES	M
SPENCER DAVIS GROUP	M
SPICE GIRLS	F
SPILLER	M
SPIN DOCTORS	M
SPINNERS	M
SPIRIT	M
SPIRITUALIZED	M
SPLIT ENZ	M
SPOKESMEN	M
SPRINGERS	M
SPRINGFIELDS	M
SQUEEZE	M
STACIE ORRICO	F
STAIND	M
STAN FREBERG	M
STAN MEISSNER	M
STANDS	M
STANLEY HOLLOWAY	M
STAPLE SINGERS	M
STARBUCK	M
STARSHIP	M
STATE OF THE HEART	M
STATUS QUO	M
STEALERS WHEEL	M
STEAM	M
STEELEYE SPAN	M
STEELY DAN	M
STEINER	M
STEPHANIE MILLS	F
STEPHEN 'TIN TIN' DUFFY	M
STEPHEN FRETWELL	M
STEPHEN STILLS	M
STEPPENWOLF	M
STEPS	M
STEREO MC'S	M
STEREO MCS	M
STEREOPHONICS	M
STEVE ARRINGTON	M
STEVE BALSAMO	M
STEVE EARLE	M
STEVE FORBERT	M
STEVE HARLEY & COCKNEY REBEL	M
STEVE MILLER BAND	M
STEVE PERRY	M
STEVE WINWOOD	M
STEVIE B	M
STEVIE NICKS	F
STEVIE WONDER	M
STILL CORNERS	M
STILTSKIN	M
STING	M
STONE PONEYS	M
STONE ROSES	M
STOOGES	M
STRANGELOVES	M
STRANGER & GLADDY	M
STRANGLERS	M
STRAWBERRY ALARM CLOCK	M
STRAWBERRY SWITCHBLADE	M
STRAWBS	M
STRAY CATS	M
STRETCH 'N' VERN	M
STRIKE	M
STROKES	M
STYLE COUNCIL	M
STYLISTICS	M
STYX	M
SUE NICHOLLS	F
SUE THOMPSON	F
SUEDE	M
SUGABABES	F
SUGAR MINOTT	M
SUGAR RAY	M
SUGARHILL GANG	M
SUN DRAGON	M
SUNDAYS	M
SUNSCREEM	M
SUNSHINE COMPANY	M
SUPER FURRY ANIMALS	M
SUPERGRASS	M
SUPERTRAMP	M
SUPREMES	F
SUREFIRE	M
SURFARIS	M
SURFERS	M
SURVIVOR	M
SUSAN CHRISTIE	F
SUSAN FASSBENDER	F
SUSAN MAUGHAN	F
SUSAN RAYE	F
SUTHERLAND BROTHERS & QUIVER	M
SUZANNE VEGA	F
SUZI QUATRO	F
SUZY & THE RED STRIPES	F
SWANSWAY	M
SWEDISH HOUSE MAFIA	M
SWEET	M
SWEET INSPIRATIONS	M
SWEET SENSATION	M
SWIMMING WITH SHARKS	M
SWING OUT SISTER	F
SWINGING BLUE JEANS	M
SYD MATTERS	M
SYDNEY YOUNGBLOOD	M
SYLVIA	F
SYNDICATE OF SOUND	M
SYSTEM	M
T'PAU	M
T.O.M.	M
T.REX	M
TAB HUNTER	M
TACKLE	M
TAIO CRUZ	M
TAIO CRUZ & KE$HA	M
TAIO CRUZ & LUCIANA CAPORASO	M
TAIO CRUZ & LUDACRIS	M
TAIO CRUZ & TINCHY STRYDER	M
TAJA SEVELLE	F
TAKE THAT	M
TALK TALK	M
TALKING HEADS	M
TAMI LYNN	F
TAMMI TERRELL	F
TAMMY WYNETTE	F
TAMS	M
TASMIN ARCHER	F
TATU	M
TAVARES	M
TAWNY REED	M
TAXI	M
TAYLOR DAYNE	F
TAYLOR SWIFT	F
TEACH IN	M
TEARDROP EXPLODES	M
TEARS FOR FEARS	M
TECHNOTRONIC FEAT. NELLY	M
TED NUGENT	M
TEDDY BEARS	M
TEDDY JOHNSON & PEARL CARR	M/F
TEDDY THOMPSON	M
TEE SET	M
TEENA MARIE	F
TEENAGE FANCLUB	M
TEENAGERS	M
TEMPERANCE SEVEN	M
TEMPTATIONS	M
TEMPTATIONS FEAT. RICK JAMES	M
TEN YEARS AFTER	M
TENNESSEE ERNIE FORD	M
TENNORS	M
TERENCE TRENT D'ARBY	M
TERESA BREWER	F
TERRI WELLS	F
TERRORVISION	M
TERRY DENE	M
TERRY JACKS	M
TERRY MAXX	M
TERRY REID	M
TERRY STAFFORD	M
TEXAS	M/F
TEXAS & WU-TANG CLAN	M/F
THANE RUSSELL & THREE	M
THEM	M
THEN JERICHO	M
THEY MIGHT BE GIANTS	M
THIN LIZZY	M
THIRD WORLD	M
THIRTEEN SENSES	M
THIRTEENTH FLOOR ELEVATORS	M
THOMAS DOLBY	M
THOMPSON TWINS	M
THORNS	M
THREE AMIGOS	M
THREE DEGREES	F
THREE DOG NIGHT	M
THREE O'CLOCK	M
THRILLS	M
THUNDER	M
THUNDERBIRDS ARE GO	M
THUNDERCLAP NEWMAN	M
TIFFANY	F
TIFT MERRITT	F
TIGHT FIT	M/F
TIM BUCKLEY	M
TIM HARDIN	M
TIM ROSE	M
TIM VINE	M
TIMBALAND	M
TIME	M
TIMEBOX	M
TIMI YURO	M
TIMMY THOMAS	M
TIN TIN OUT	M
TINA ARENA	F
TINA BRITT	F
TINA COUSINS	F
TINA TURNER	F
TINY DANCERS	F
TOBY LIGHTMAN	M
TODD RUNDGREN	M
TODD TERRY	M
TOM BAXTER	M
TOM CLOUD	M
TOM COCHRANE & RED RIDER	M
TOM JONES	M
TOM JONES & CERYS MATTHEWS	M
TOM ODELL	M
TOM PETTY	M
TOM ROBINSON	M
TOM RUSH	M
TOM SPEIGHT	M
TOM THUMB CIGARS	M
TOM TOM CLUB	M
TOMMY BOYCE	M
TOMMY BRUCE	M
TOMMY DORSEY	M
TOMMY EDWARDS	M
TOMMY JAMES AND THE SHONDELLS	M
TOMMY QUICKLY & THE REMO FOUR	M
TOMMY ROE	M
TOMMY SPARKS	M
TOMMY STEELE	M
TOMMY TUCKER	M
TONI BASIL	F
TONI BRAXTON	F
TONI BRAXTON & KENNY GEE	M/F
TONY BENNETT	M
TONY BRENT	M
TONY HATCH ORCHESTRA	M
TONY JACKSON & THE VIBRATIONS	M
TONY JACKSON WITH THE VIBRATIONS	M
TONY JOE WHITE	M
TONY MARTIN	M
TONY RIVERS & THE CASTAWAYS	M
TOPLOADER	M
TORI AMOS	F
TORNADOS	M
TOTO	M
TOTO COELO	M
TOYAH	F
TOYS	M
TQ	M
TRACEY ULLMAN	F
TRACY CHAPMAN	F
TRACY ULLMAN	F
TRADEWINDS	M
TRAFFIC	M
TRAFFIC JAM	M
TRAIN	M
TRAITS	M
TRAMMPS	M
TRANSVISION VAMP	M
TRASHMEN	M
TRAVELING WILBURYS	M
TRAVIS	M
TREMELOES	M
TRENDS	M
TREVOR WALTERS	M
TRINI LOPEZ	M
TRIO	M
TROGGS	M
TROYE SIVAN	M
TROYE SIVAN AND KACEY MUSGRAVES	M/F
TRUESTEPPERS FEAT. BRIAN HARVEY	M
TRULY SMITH	F
TRUTH	M
TUBES	M
TUBEWAY ARMY	M
TUDOR QUEEN	M
TURIN BRAKES	M
TURTLES	M
TUSSE	F
TWEENIES	M
TWENTY 4 SEVEN	M
TWICE AS MUCH	M
TWINKLE	F
TWISTED SISTER	M
TYMES	M
TYPICALLY TROPICAL	M
U.S.U.R.A.	M
U2	M
U2 FEAT. BB KING	M/F
UB 40 AND ROBERT PALMER	M
UB40	M
UFO	M
UGLY KID JOE	M
UGLYS	M
UK SUBS	M
ULTRA	M
ULTRA NATE	M
ULTRABEAT	M
ULTRAVOX	M
UNDERCOVER	M
UNDERTAKERS	M
UNDERTONES	M
UNDERWORLD	M
UNIQUES	M
UNIT 4+2	M
UPPER ROOM	M
URIAH HEEP	M
UTAH SAINTS	M
VAL BENNETT	M
VAL DOONICAN	M
VALERIE MITCHELL	F
VAMPS	M
VAMPS & MATOMA	M
VAN HALEN	M
VAN MORRISON	M
VANESSA AMOROSI	F
VANESSA CARLTON	F
VANESSA PARADIS	F
VANESSA WILLIAMS	F
VANGELIS	M
VANILLA FUDGE	M
VANILLA ICE	M
VANITY FARE	M
VAPORS	M
VASCONCELOS	M
VASHTI	M
VEJTABLES	M/F
VELVELETTES	F
VELVET UNDERGROUND	M
VELVET UNDERGROUND AND NICO	M
VENACCIO & DAIGON	M
VENGABOYS	M
VENTURES	M
VERACOCHA	M
VERDELLE SMITH	F
VERNONS GIRLS	F
VERVE	M
VESSELS	M
VESTA WILLIAMS	F
VIC DAMONE	M
VIKKI CARR	F
VIPERS SKIFFLE GROUP	M
VISAGE	M
VIXEN	F
VOGUES	M
VOICE OF THE BEEHIVE	F
VOWS	M
WACKERS	M
WAITRESSES	M/F
WALK THE MOON	M
WALKER BROTHERS	M
WALLS	M
WANDA JACKSON	F
WANG CHUNG	M
WANNADIES	M
WANTED	M
WARM SOUNDS	M
WARP BROS VS AQUAGEN	M
WARRANT	M
WARREN ZEVON	M
WAS (NOT WAS)	M
WATERBOYS	M
WATERFRONT	M
WAVELENGTH	M
WAX	M
WAY OUT WEST	M
WAYNE FONTANA	M
WE FIVE	M
WE THE PEOPLE	M
WEATHER GIRLS	F
WEAVERS	M
WEBB SISTERS	F
WEEKEND	M
WEEKND	M
WENDY MOTEN	F
WESTLIFE	M
WET WET WET	M
WHAM!	M
WHEEL-A-WAYS	M
WHISPERS	M
WHISTLING JACK SMITH	M
WHITE AND TORCH	M
WHITE LION	M
WHITE PLAINS	M
WHITE TOWN	M
WHITESNAKE	M
WHITNEY HOUSTON	F
WHO	M
WILD CHERRY	M
WILDCHILD	M
WILDHEARTS	M
WILL DOWNING	M
WILL POWERS	F
WILL TO POWER	F
WILL YOUNG	M
WILLIAM BELL	M
WILLIE HUTCH	M
WILLIE MITCHELL	M
WILLIE NELSON	M
WILLIE NELSON AND LEE ANN WOMACK	M/F
WILSON PHILLIPS	F
WILSON PICKETT	M
WINDJAMMER	M
WINGS	M/F
WIRE DAISIES	M
WISHBONE ASH	M
WIZ KHALIFA	M
WIZZARD	M
WOGAN WALTERS MARSH	M
WOLF ALICE	M/F
WOLFMAN FEAT. PETER DOHERTY	M
WOMACK AND WOMACK	M/F
WONDERLAND	M
WOOKIE FEAT. LAIN	M
WORLD PARTY	M
WYCLEF JEAN	M
X AMBASSADORS	M
XPANSIONS	M
XPRESS 2	M
XTC	M
YARBROUGH AND PEOPLES	M
YARDBIRDS	M
YAZOO	M/F
YAZZ	F
YAZZ AND THE PLASTIC POPULATION	M/F
YEARS AND YEARS	M
YEARS AND YEARS AND KYLIE MINOGUE	M/F
YELL	M
YELLO	M
YELLOW DOG	M
YES	M
YOMANDA	M
YORK	M
YOUNG IDEA	M
YOUNG RASCALS	M
YOUNGBLOODS	M
YVONNE ELLIMAN	F
YY28'S	M
ZAGER AND EVANS	M
ZIGGY MARLEY	M
ZINC DJ	M
ZING	M
ZOE MAZAH	F
ZOMBIE NATION	M
ZOMBIES	M
ZOO BRAZIL	M
ZOOT MONEY'S BIG ROLL BAND	M
ZUCCHERO	M
ZZ TOP	M
	
	
	
	
	
	
	
	
	
	
	
	
	
	
	
	
	
	
	
	
	
	
	
	
	
	
	
	
	
	
	
	
	
	
	
	
	
	
	
	
	
	
	
	
	
	
	
	
	
	
	
	
	
	
	
	
	
	
	
	
	
	
	
	
	
	
	
	
	
	
	
	
	
	
	
	
	
	
	
	
	
	
	
	
	
	
	
	
	
	
	
	
	
	
	
	
	
	
	
	
	
	
	
	
	
	
	
	
	
	
	
	
	
	
	
	
	
	
	
	
	
	
	
	
	
	
	
	
	
	
	
	
	
	
	
	
	
	
	
	
	
	
	
	
	
	
	
	
	
	
	
	
	
	
	
	
	
	
	
	
	
	
	
	
	
	
	
	
	
	
	
	
	
	
	
	
	
	
	
	
	
	
	
	
	
	
	
	
	
	
	
	
	
	
	
	
	
	
	
	
	
	
	
	
	
	
	
	
	
	
	
	
	
	
	
	
	
	
	
	
	
	
	
	
	
	
	
	
	
	
	
	
	
	
	
	
	
	
	
	
	
	
	
	
	
	
	
	
	
	
	
	
	
	
	
	
	
	
	
	
	
	
	
	
	
	
	
	
	
	
	
	
	
	
	
	
	
	
	
	
	
	
	
	
	
	
	
	
	
	
	
	
	
	
	
	
	
	
	
	
	
	
	
	
	
	
	
	
	
	
	
	
	
	
	
	
	
	
	
	
	
	
	
	
	
	
	
	
	
	
	
	
	
	
	
	
	
	
	
	
	
	
	
	
	
	
	
	
	
	
	
	
	
	
	
	
	
	
	
	
	
	
	
	
	
	
	
	
	
	
	
	
	
	
	
	
	
	
	
	
	
	
	
	
	
	
	
	
	
	
	
	
	
	
	
	
	
	
	
	
	
	
	
	
	
	
	
	
	
	
	
	
	
	
	
	
	
	
	
	
	
	
	
	
	
	
	
	
	
	
	
	
	
	
	
	
	
	
	
	
	
	
	
	
	
	
	
	
	
	
	
	
	
	
	
	
	
	
	
	
	
	
	
	
	
	
	
	
	
	
	
	
	
	
	
	
	
	
	
	
	
	
	
	
	
	
	
	
	
	
	
	
	
	
	
	
	
	
	
	
	
	
	
	
	
	
	
	
	
	
	
	
	
	
	
	
	
	
	
	
	
	
	
	
	
	
	
	
	
	
	
	
	
	
	
	
	
	
	
	
	
	
	
	
	
	
	
	
	
	
	
	
	
	
	
	
	
	
	
	
	
	
	
	
	
	
	
	
	
	
	
	
	
	
	
	
	
	
	
	
	
	
	
	
	
	
	
	
	
	
	
	
	
	
	
	
	
	
	
	
	
	
	
	
	
	
	
	
	
	
	
	
	
	
	
	
	
	
	
	
	
	
	
	
	
	
	
	
	
	
	
	
	
	
	
	
	
	
	
	
	
	
	
	
	
	
	
	
	
	
	
	
	
	
	
	
	
	
	
	
	
	
	
	
	
	
	
	
	
	
	
	
	
	
	
	
	
	
	
	
	
	
	
	
	
	
	
	
	
	
	
	
	
	
	
	
	
	
	
	
	
	
	
	
	
	
	
	
	
	
	
	
	
	
	
	
	
	
	
	
	
	
	
	
	
	
	
	
	
	
	
	
	
	
	
	
	
	
	
	
	
	
	
	
	
	
	
	
	
	
	
	
	
	
	
	
	
	
	
	
	
	
	
	
	
	
	
	
	
	
	
	
	
	
	
	
	
	
	
	
	
	
	
	
	
	
	
	
	
	
	
	
	
	
	
	
	
	
	
	
	
	
	
	
	
	
	
	
	
	
	
	
	
	
	
	
	
	
	
	
	
	
	
	
	
	
	
	
	
	
	
	
	
	
	
	
	
	
	
	
	
	
	
	
	
	
	
	
	
	
	
	
	
	
	
	
	
	
	
	
	
	
	
	
	
	
	
	
	
	
	
	
	
	
	
	
	
	
	
	
	
	
	
	
	
	
	
	
	
	
	
	
	
	
	
	
	
	
	
	
	
	
	
	
	
	
	
	
	
	
	
	
	
	
	
	
	
	
	
	
	
	
	
	
	
	
	
	
	
	
	
	
	
	
	
	
	
	
	
	
	
	
	
	
	
	
	
	
	
	
	
	
	
	
	
	
	
	
	
	
	
	
	
	
	
	
	
	
	
	
	
	
	
	
	
	
	
	
	
	
	
	
	
	
	
	
	
	
	
	
	
	
	
	
	
	
	
	
	
	
	
	
	
	
	
	
	
	
	
	
	
	
	
	
	
	
	
	
	
	
	
	
	
	
	
	
	
	
	
	
	
	
	
	
	
	
	
	
	
	
	
	
	
	
	
	
	
	
	
	
	
	
	
	
	
	
	
	
	
	
	
	
	
	
	
	
	
	
	
	
	
	
	
	
	
	
	
	
	
	
	
	
	
	
	
	
	
	
	
	
	
	
	
	
	
	
	
	
	
	
	
	
	
	
	
	
	
	
	
	
	
	
	
	
	
	
	
	
	
	
	
	
	
	
	
	
	
	
	
	
	
	
	
	
	
	
	
	
	
	
	
	
	
	
	
	
	
	
	
	
	
	
	
	
	
	
	
	
	
	
	
	
	
	
	
	
	
	
	
	
	
	
	
	
	
	
	
	
	
	
	
	
	
	
	
	
	
	
	
	
	
	
	
	
	
	
	
	
	
	
	
	
	
	
	
	
	
	
	
	
	
	
	
	
	
	
	
	
	
	
	
	
	
	
	
	
	
	
	
	
	
	
	
	
	
	
	
	
	
	
	
	
	
	
	
	
	
	
	
	
	
	
	
	
	
	
	
	
	
	
	
	
	
	
	
	
	
	
	
	
	
	
	
	
	
	
	
	
	
	
	
	
	
	
	
	
	
	
	
	
	
	
	
	
	
	
	
	
	
	
	
	
	
	
	
	
	
	
	
	
	
	
	
	
	
	
	
	
	
	
	
	
	
	
	
	
	
	
	
	
	
	
	
	
	
	
	
	
	
	
	
	
	
	
	
	
	
	
	
	
	
	
	
	
	
	
	
	
	
	
	
	
	
	
	
	
	
	
	
	
	
	
	
	
	
	
	
	
	
	
	
	
	
	
	
	
	
	
	
	
	
	
	
	
	
	
	
	
	
	
	
	
	
	
	
	
	
	
	
	
	
	
	
	
	
	
	
	
	
	
	
	
	
	
	
	
	
	
	
	
	
	
	
	
	
	
	
	
	
	
	
	
	
	
	
	
	
	
	
	
	
	
	
	
	
	
	
	
	
	
	
	
	
	
	
	
	
	
	
	
	
	
	
	
	
	
	
	
	
	
	
	
	
	
	
	
	
	
	
	
	
	
	
	
	
	
	
	
	
	
	
	
	
	
	
	
	
	
	
	
	
	
	
	
	
	
	
	
	
	
	
	
	
	
	
	
	
	
	
	
	
	
	
	
	
	
	
	
	
	
	
	
	
	
	
	
	
	
	
	
	
	
	
	
	
	
	
	
	
	
	
	
	
	
	
	
	
	
	
	
	
	
	
	
	
	
	
	
	
	
	
	
	
	
	
	
	
	
	
	
	
	
	
	
	
	
	
	
	
	
	
	
	
	
	
	
	
	
	
	
	
	
	
	
	
	
	
	
	
	
	
	
	
	
	
	
	
	
	
	
	
	
	
	
	
	
	
	
	
	
	
	
	
	
	
	
	
	
	
	
	
	
	
	
	
	
	
	
	
	
	
	
	
	
	
	
	
	
	
	
	
	
	
	
	
	
	
	
	
	
	
	
	
	
	
	
	
	
	
	
	
	
	
	
	
	
	
	
	
	
	
	
	
	
	
	
	
	
	
	
	
	
	
	
	
	
	
	
	
	
	
	
	
	
	
	
	
	
	
	
	
	
	
	
	
	
	
	
	
	
	
	
	
	
	
	
	
	
	
	
	
	
	
	
	
	
	
	
	
	
	
	
	
	
	
	
	
	
	
	
	
	
	
	
	
	
	
	
	
	
	
	
	
	
	
	
	
	
	
	
	
	
	
	
	
	
	
	
	
	
	
	
	
	
	
	
	
	
	
	
	
	
	
	
	
	
	
	
	
	
	
	
	
	
	
	
	
	
	
	
	
	
	
	
	
	
	
	
	
	
	
	
	
	
	
	
	
	
	
	
	
	
	
	
	
	
	
	
	
	
	
	
	
	
	
	
	
	
	
	
	
	
	
	
	
	
	
	
	
	
	
	
	
	
	
	
	
	
	
	
	
	
	
	
	
	
	
	
	
	
	
	
	
	
	
	
	
	
	
	
	
	
	
	
	
	
	
	
	
	
	
	
	
	
	
	
	
	
	
	
	
	
	
	
	
	
	
	
	
	
	
	
	
	
	
	
	
	
	
	
	
	
	
	
	
	
	
	
	
	
	
	
	
	
	
	
	
	
	
	
	
	
	
	
	
	
	
	
	
	
	
	
	
	
	
	
	
	
	
	
	
	
	
	
	
	
	
	
	
	
	
	
	
	
	
	
	
	
	
	
	
	
	
	
	
	
	
	
	
	
	
	
	
	
	
	
	
	
	
	
	
	
	
	
	
	
	
	
	
	
	
	
	
	
	
	
	
	
	
	
	
	
	
	
	
	
	
	
	
	
	
	
	
	
	
	
	
	
	
	
	
	
	
	
	
	
	
	
	
	
	
	
	
	
	
	
	
	
	
	
	
	
	
	
	
	
	
	
	
	
	
	
	
	
	
	
	
	
	
	
	
	
	
	
	
	
	
	
	
	
	
	
	
	
	
	
	
	
	
	
	
	
	
	
	
	
	
	
	
	
	
	
	
	
	
	
	
	
	
	
	
	
	
	
	
	
	
	
	
	
	
	
	
	
	
	
	
	
	
	
	
	
	
	
	
	
	
	
	
	
	
	
	
	
	
	
	
	
	
	
	
	
	
	
	
	
	
	
	
	
	
	
	
	
	
	
	
	
	
	
	
	
	
	
	
	
	
	
	
	
	
	
	
	
	
	
	
	
	
	
	
	
	
	
	
	
	
	
	
	
	
	
	
	
	
	
	
	
	
	
	
	
	
	
	
	
	
	
	
	
	
	
	
	
	
	
	
	
	
	
	
	
	
	
	
	
	
	
	
	
	
	
	
	
	
	
	
	
	
	
	
	
	
	
	
	
	
	
	
	
	
	
	
	
	
	
	
	
	
	
	
	
	
	
	
	
	
	
	
	
	
	
	
	
	
	
	
	
	
	
	
	
	
	
	
	
	
	
	
	
	
	
	
	
	
	
	
	
	
	
	
	
	
	
	
	
	
	
	
	
	
	
	
	
	
	
	
	
	
	
	
	
	
	
	
	
	
	
	
	
	
	
	
	
	
	
	
	
	
	
	
	
	
	
	
	
	
	
	
	
	
	
	
	
	
	
	
	
	
	
	
	
	
	
	
	
	
	
	
	
	
	
	
	
	
	
	
	
	
	
	
	
	
	
	
	
	
	
	
	
	
	
	
	
	
	
	
	
	
	
	
	
	
	
	
	
	
	
	
	
	
	
	
	
	
	
	
	
	
	
	
	
	
	
	
	
	
	
	
	
	
	
	
	
	
	
	
	
	
	
	
	
	
	
	
	
	
	
	
	
	
	
	
	
	
	
	
	
	
	
	
	
	
	
	
	
	
	
	
	
	
	
	
	
	
	
	
	
	
	
	
	
	
	
	
	
	
	
	
	
	
	
	
	
	
	
	
	
	
	
	
	
	
	
	
	
	
	
	
	
	
	
	
	
	
	
	
	
	
	
	
	
	
	
	
	
	
	
	
	
	
	
	
	
	
	
	
	
	
	
	
	
	
	
	
	
	
	
	
	
	
	
	
	
	
	
	
	
	
	
	
	
	
	
	
	
	
	
	
	
	
	
	
	
	
	
	
	
	
	
	
	
	
	
	
	
	
	
	
	
	
	
	
	
	
	
	
	
	
	
	
	
	
	
	
	
	
	
	
	
	
	
	
	
	
	
	
	
	
	
	
	
	
	
	
	
	
	
	
	
	
	
	
	
	
	
	
	
	
	
	
	
	
	
	
	
	
	
	
	
	
	
	
	
	
	
	
	
	
	
	
	
	
	
	
	
	
	
	
	
	
	
	
	
	
	
	
	
	
	
	
	
	
	
	
	
	
	
	
	
	
	
	
	
	
	
	
	
	
	
	
	
	
	
	
	
	
	
	
	
	
	
	
	
	
	
	
	
	
	
	
	
	
	
	
	
	
	
	
	
	
	
	
	
	
	
	
	
	
	
	
	
	
	
	
	
	
	
	
	
	
	
	
	
	
	
	
	
	
	
	
	
	
	
	
	
	
	
	
	
	
	
	
	
	
	
	
	
	
	
	
	
	
	
	
	
	
	
	
	
	
	
	
	
	
	
	
	
	
	
	
	
	
	
	
	
	
	
	
	
	
	
	
	
	
	
	
	
	
	
	
	
	
	
	
	
	
	
	
	
	
	
	
	
	
	
	
	
	
	
	
	
	
	
	
	
	
	
	
	
	
	
	
	
	
	
	
	
	
	
	
	
	
	
	
	
	
	
	
	
	
	
	
	
	
	
	
	
	
	
	
	
	
	
	
	
	
	
	
	
	
	
	
	
	
	
	
	
	
	
	
	
	
	
	
	
	
	
	
	
	
	
	
	
	
	
	
	
	
	
	
	
	
	
	
	
	
	
	
	
	
	
	
	
	
	
	
	
	
	
	
	
	
	
	
	
	
	
	
	
	
	
	
	
	
	
	
	
	
	
	
	
	
	
	
	
	
	
	
	
	
	
	
	
	
	
	
	
	
	
	
	
	
	
	
	
	
	
	
	
	
	
	
	
	
	
	
	
	
	
	
	
	
	
	
	
	
	
	
	
	
	
	
	
	
	
	
	
	
	
	
	
	
	
	
	
	
	
	
	
	
	
	
	
	
	
	
	
	
	
	
	
	
	
	
	
	
	
	
	
	
	
	
	
	
	
	
	
	
	
	
	
	
	
	
	
	
	
	
	
	
	
	
	
	
	
	
	
	
	
	
	
	
	
	
	
	
	
	
	
	
	
	
	
	
	
	
	
	
	
	
	
	
	
	
	
	
	
	
	
	
	
	
	
	
	
	
	
	
	
	
	
	
	
	
	
	
	
	
	
	
	
	
	
	
	
	
	
	
	
	
	
	
	
	
	
	
	
	
	
	
	
	
	
	
	
	
	
	
	
	
	
	
	
	
	
	
	
	
	
	
	
	
	
	
	
	
	
	
	
	
	
	
	
	
	
	
	
	
	
	
	
	
	
	
	
	
	
	
	
	
	
	
	
	
	
	
	
	
	
	
	
	
	
	
	
	
	
	
	
	
	
	
	
	
	
	
	
	
	
	
	
	
	
	
	
	
	
	
	
	
	
	
	
	
	
	
	
	
	
	
	
	
	
	
	
	
	
	
	
	
	
	
	
	
	
	
	
	
	
	
	
	
	
	
	
	
	
	
	
	
	
	
	
	
	
	
	
	
	
	
	
	
	
	
	
	
	
	
	
	
	
	
	
	
	
	
	
	
	
	
	
	
	
	
	
	
	
	
	
	
	
	
	
	
	
	
	
	
	
	
	
	
	
	
	
	
	
	
	
	
	
	
	
	
	
	
	
	
	
	
	
	
	
	
	
	
	
	
	
	
	
	
	
	
	
	
	
	
	
	
	
	
	
	
	
	
	
	
	
	
	
	
	
	
	
	
	
	
	
	
	
	
	
	
	
	
	
	
	
	
	
	
	
	
	
	
	
	
	
	
	
	
	
	
	
	
	
	
	
	
	
	
	
	
	
	
	
	
	
	
	
	
	
	
	
	
	
	
	
	
	
	
	
	
	
	
	
	
	
	
	
	
	
	
	
	
	
	
	
	
	
	
	
	
	
	
	
	
	
	
	
	
	
	
	
	
	
	
	
	
	
	
	
	
	
	
	
	
	
	
	
	
	
	
	
	
	
	
	
	
	
	
	
	
	
	
	
	
	
	
	
	
	
	
	
	
	
	
	
	
	
	
	
	
	
	
	
	
	
	
	
	
	
	
	
	
	
	
	
	
	
	
	
	
	
	
	
	
	
	
	
	
	
	
	
	
	
	
	
	
	
	
	
	
	
	
	
	
	
	
	
	
	
	
	
	
	
	
	
	
	
	
	
	
	
	
	
	
	
	
	
	
	
	
	
	
	
	
	
	
	
	
	
	
	
	
	
	
	
	
	
	
	
	
	
	
	
	
	
	
	
	
	
	
	
	
	
	
	
	
	
	
	
	
	
	
	
	
	
	
	
	
	
	
	
	
	
	
	
	
	
	
	
	
	
	
	
	
	
	
	
	
	
	
	
	
	
	
	
	
	
	
	
	
	
	
	
	
	
	
	
	
	
	
	
	
	
	
	
	
	
	
	
	
	
	
	
	
	
	
	
	
	
	
	
	
	
	
	
	
	
	
	
	
	
	
	
	
	
	
	
	
	
	
	
	
	
	
	
	
	
	
	
	
	
	
	
	
	
	
	
	
	
	
	
	
	
	
	
	
	
	
	
	
	
	
	
	
	
	
	
	
	
	
	
	
	
	
	
	
	
	
	
	
	
	
	
	
	
	
	
	
	
	
	
	
	
	
	
	
	
	
	
	
	
	
	
	
	
	
	
	
	
	
	
	
	
	
	
	
	
	
	
	
	
	
	
	
	
	
	
	
	
	
	
	
	
	
	
	
	
	
	
	
	
	
	
	
	
	
	
	
	
	
	
	
	
	
	
	
	
	
	
	
	
	
	
	
	
	
	
	
	
	
	
	
	
	
	
	
	
	
	
	
	
	
	
	
	
	
	
	
	
	
	
	
	
	
	
	
	
	
	
	
	
	
	
	
	
	
	
	
	
	
	
	
	
	
	
	
	
	
	
	
	
	
	
	
	
	
	
	
	
	
	
	
	
	
	
	
	
	
	
	
	
	
	
	
	
	
	
	
	
	
	
	
	
	
	
	
	
	
	
	
	
	
	
	
	
	
	
	
	
	
	
	
	
	
	
	
	
	
	
	
	
	
	
	
	
	
	
	
	
	
	
	
	
	
	
	
	
	
	
	
	
	
	
	
	
	
	
	
	
	
	
	
	
	
	
	
	
	
	
	
	
	
	
	
	
	
	
	
	
	
	
	
	
	
	
	
	
	
	
	
	
	
	
	
	
	
	
	
	
	
	
	
	
	
	
	
	
	
	
	
	
	
	
	
	
	
	
	
	
	
	
	
	
	
	
	
	
	
	
	
	
	
	
	
	
	
	
	
	
	
	
	
	
	
	
	
	
	
	
	
	
	
	
	
	
	
	
	
	
	
	
	
	
	
	
	
	
	
	
	
	
	
	
	
	
	
	
	
	
	
	
	
	
	
	
	
	
	
	
	
	
	
	
	
	
	
	
	
	
	
	
	
	
	
	
	
	
	
	
	
	
	
	
	
	
	
	
	
	
	
	
	
	
	
	
	
	
	
	
	
	
	
	
	
	
	
	
	
	
	
	
	
	
	
	
	
	
	
	
	
	
	
	
	
	
	
	
	
	
	
	
	
	
	
	
	
	
	
	
	
	
	
	
	
	
	
	
	
	
	
	
	
	
	
	
	
	
	
	
	
	
	
	
	
	
	
	
	
	
	
	
	
	
	
	
	
	
	
	
	
	
	
	
	
	
	
	
	
	
	
	
	
	
	
	
	
	
	
	
	
	
	
	
	
	
	
	
	
	
	
	
	
	
	
	
	
	
	
	
	
	
	
	
	
	
	
	
	
	
	
	
	
	
	
	
	
	
	
	
	
	
	
	
	
	
	
	
	
	
	
	
	
	
	
	
	
	
	
	
	
	
	
	
	
	
	
	
	
	
	
	
	
	
	
	
	
	
	
	
	
	
	
	
	
	
	
	
	
	
	
	
	
	
	
	
	
	
	
	
	
	
	
	
	
	
	
	
	
	
	
	
	
	
	
	
	
	
	
	
	
	
	
	
	
	
	
	
	
	
	
	
	
	
	
	
	
	
	
	
	
	
	
	
	
	
	
	
	
	
	
	
	
	
	
	
	
	
	
	
	
	
	
	
	
	
	
	
	
	
	
	
	
	
	
	
	
	
	
	
	
	
	
	
	
	
	
	
	
	
	
	
	
	
	
	
	
	
	
	
	
	
	
	
	
	
	
	
	
	
	
	
	
	
	
	
	
	
	
	
	
	
	
	
	
	
	
	
	
	
	
	
	
	
	
	
	
	
	
	
	
	
	
	
	
	
	
	
	
	
	
	
	
	
	
	
	
	
	
	
	
	
	
	
	
	
	
	
	
	
	
	
	
	
	
	
	
	
	
	
	
	
	
	
	
	
	
	
	
	
	
	
	
	
	
	
	
	
	
	
	
	
	
	
	
	
	
	
	
	
	
	
	
	
	
	
	
	
	
	
	
	
	
	
	
	
	
	
	
	
	
	
	
	
	
	
	
	
	
	
	
	
	
	
	
	
	
	
	
	
	
	
	
	
	
	
	
	
	
	
	
	
	
	
	
	
	
	
	
	
	
	
	
	
	
	
	
	
	
	
	
	
	
	
	
	
	
	
	
	
	
	
	
	
	
	
	
	
	
	
	
	
	
	
	
	
	
	
	
	
	
	
	
	
	
	
	
	
	
	
	
	
	
	
	
	
	
	
	
	
	
	
	
	
	
	
	
	
	
	
	
	
	
	
	
	
	
	
	
	
	
	
	
	
	
	
	
	
	
	
	
	
	
	
	
	
	
	
	
	
	
	
	
	
	
	
	
	
	
	
	
	
	
	
	
	
	
	
	
	
	
	
	
	
	
	
	
	
	
	
	
	
	
	
	
	
	
	
	
	
	
	
	
	
	
	
	
	
	
	
	
	
	
	
	
	
	
	
	
	
	
	
	
	
	
	
	
	
	
	
	
	
	
	
	
	
	
	
	
	
	
	
	
	
	
	
	
	
	
	
	
	
	
	
	
	
	
	
	
	
	
	
	
	
	
	
	
	
	
	
	
	
	
	
	
	
	
	
	
	
	
	
	
	
	
	
	
	
	
	
	
	
	
	
	
	
	
	
	
	
	
	
	
	
	
	
	
	
	
	
	
	
	
	
	
	
	
	
	
	
	
	
	
	
	
	
	
	
	
	
	
	
	
	
	
	
	
	
	
	
	
	
	
	
	
	
	
	
	
	
	
	
	
	
	
	
	
	
	
	
	
	
	
	
	
	
	
	
	
	
	
	
	
	
	
	
	
	
	
	
	
	
	
	
	
	
	
	
	
	
	
	
	
	
	
	
	
	
	
	
	
	
	
	
	
	
	
	
	
	
	
	
	
	
	
	
	
	
	
	
	
	
	
	
	
	
	
	
	
	
	
	
	
	
	
	
	
	
	
	
	
	
	
	
	
	
	
	
	
	
	
	
	
	
	
	
	
	
	
	
	
	
	
	
	
	
	
	
	
	
	
	
	
	
	
	
	
	
	
	
	
	
	
	
	
	
	
	
	
	
	
	
	
	
	
	
	
	
	
	
	
	
	
	
	
	
	
	
	
	
	
	
	
	
	
	
	
	
	
	
	
	
	
	
	
	
	
	
	
	
	
	
	
	
	
	
	
	
	
	
	
	
	
	
	
	
	
	
	
	
	
	
	
	
	
	
	
	
	
	
	
	
	
	
	
	
	
	
	
	
	
	
	
	
	
	
	
	
	
	
	
	
	
	
	
	
	
	
	
	
	
	
	
	
	
	
	
	
	
	
	
	
	
	
	
	
	
	
	
	
	
	
	
	
	
	
	
	
	
	
	
	
	
	
	
	
	
	
	
	
	
	
	
	
	
	
	
	
	
	
	
	
	
	
	
	
	
	
	
	
	
	
	
	
	
	
	
	
	
	
	
	
	
	
	
	
	
	
	
	
	
	
	
	
	
	
	
	
	
	
	
	
	
	
	
	
	
	
	
	
	
	
	
	
	
	
	
	
	
	
	
	
	
	
	
	
	
	
	
	
	
	
	
	
	
	
	
	
	
	
	
	
	
	
	
	
	
	
	
	
	
	
	
	
	
	
	
	
	
	
	
	
	
	
	
	
	
	
	
	
	
	
	
	
	
	
	
	
	
	
	
	
	
	
	
	
	
	
	
	
	
	
	
	
	
	
	
	
	
	
	
	
	
	
	
	
	
	
	
	
	
	
	
	
	
	
	
	
	
	
	
	
	
	
	
	
	
	
	
	
	
	
	
	
	
	
	
	
	
	
	
	
	
	
	
	
	
	
	
	
	
	
	
	
	
	
	
	
	
	
	
	
	
	
	
	
	
	
	
	
	
	
	
	
	
	
	
	
	
	
	
	
	
	
	
	
	
	
	
	
	
	
	
	
	
	
	
	
	
	
	
	
	
	
	
	
	
	
	
	
	
	
	
	
	
	
	
	
	
	
	
	
	
	
	
	
	
	
	
	
	
	
	
	
	
	
	
	
	
	
	
	
	
	
	
	
	
	
	
	
	
	
	
	
	
	
	
	
	
	
	
	
	
	
	
	
	
	
	
	
	
	
	
	
	
	
	
	
	
	
	
	
	
	
	
	
	
	
	
	
	
	
	
	
	
	
	
	
	
	
	
	
	
	
	
	
	
	
	
	
	
	
	
	
	
	
	
	
	
	
	
	
	
	
	
	
	
	
	
	
	
	
	
	
	
	
	
	
	
	
	
	
	
	
	
	
	
	
	
	
	
	
	
	
	
	
	
	
	
	
	
	
	
	
	
	
	
	
	
	
	
	
	
	
	
	
	
	
	
	
	
	
	
	
	
	
	
	
	
	
	
	
	
	
	
	
	
	
	
	
	
	
	
	
	
	
	
	
	
	
	
	
	
	
	
	
	
	
	
	
	
	
	
	
	
	
	
	
	
	
	
	
	
	
	
	
	
	
	
	
	
	
	
	
	
	
	
	
	
	
	
	
	
	
	
	
	
	
	
	
	
	
	
	
	
	
	
	
	
	
	
	
	
	
	
	
	
	
	
	
	
	
	
	
	
	
	
	
	
	
	
	
	
	
	
	
	
	
	
	
	
	
	
	
	
	
	
	
	
	
	
	
	
	
	
	
	
	
	
	
	
	
	
	
	
	
	
	
	
	
	
	
	
	
	
	
	
	
	
	
	
	
	
	
	
	
	
	
	
	
	
	
	
	
	
	
	
	
	
	
	
	
	
	
	
	
	
	
	
	
	
	
	
	
	
	
	
	
	
	
	
	
	
	
	
	
	
	
	
	
	
	
	
	
	
	
	
	
	
	
	
	
	
	
	
	
	
	
	
	
	
	
	
	
	
	
	
	
	
	
	
	
	
	
	
	
	
	
	
	
	
	
	
	
	
	
	
	
	
	
	
	
	
	
	
	
	
	
	
	
	
	
	
	
	
	
	
	
	
	
	
	
	
	
	
	
	
	
	
	
	
	
	
	
	
	
	
	
	
	
	
	
	
	
	
	
	
	
	
	
	
	
	
	
	
	
	
	
	
	
	
	
	
	
	
	
	
	
	
	
	
	
	
	
	
	
	
	
	
	
	
	
	
	
	
	
	
	
	
	
	
	
	
	
	
	
	
	
	
	
	
	
	
	
	
	
	
	
	
	
	
	
	
	
	
	
	
	
	
	
	
	
	
	
	
	
	
	
	
	
	
	
	
	
	
	
	
	
	
	
	
	
	
	
	
	
	
	
	
	
	
	
	
	
	
	
	
	
	
	
	
	
	
	
	
	
	
	
	
	
	
	
	
	
	
	
	
	
	
	
	
	
	
	
	
	
	
	
	
	
	
	
	
	
	
	
	
	
	
	
	
	
	
	
	
	
	
	
	
	
	
	
	
	
	
	
	
	
	
	
	
	
	
	
	
	
	
	
	
	
	
	
	
	
	
	
	
	
	
	
	
	
	
	
	
	
	
	
	
	
	
	
	
	
	
	
	
	
	
	
	
	
	
	
	
	
	
	
	
	
	
	
	
	
	
	
	
	
	
	
	
	
	
	
	
	
	
	
	
	
	
	
	
	
	
	
	
	
	
	
	
	
	
	
	
	
	
	
	
	
	
	
	
	
	
	
	
	
	
	
	
	
	
	
	
	
	
	
	
	
	
	
	
	
	
	
	
	
	
	
	
	
	
	
	
	
	
	
	
	
	
	
	
	
	
	
	
	
	
	
	
	
	
	
	
	
	
	
	
	
	
	
	
	
	
	
	
	
	
	
	
	
	
	
	
	
	
	
	
	
	
	
	
	
	
	
	
	
	
	
	
	
	
	
	
	
	
	
	
	
	
	
	
	
	
	
	
	
	
	
	
	
	
	
	
	
	
	
	
	
	
	
	
	
	
	
	
	
	
	
	
	
	
	
	
	
	
	
	
	
	
	
	
	
	
	
	
	
	
	
	
	
	
	
	
	
	
	
	
	
	
	
	
	
	
	
	
	
	
	
	
	
	
	
	
	
	
	
	
	
	
	
	
	
	
	
	
	
	
	
	
	
	
	
	
	
	
	
	
	
	
	
	
	
	
	
	
	
	
	
	
	
	
	
	
	
	
	
	
	
	
	
	
	
	
	
	
	
	
	
	
	
	
	
	
	
	
	
	
	
	
	
	
	
	
	
	
	
	
	
	
	
	
	
	
	
	
	
	
	
	
	
	
	
	
	
	
	
	
	
	
	
	
	
	
	
	
	
	
	
	
	
	
	
	
	
	
	
	
	
	
	
	
	
	
	
	
	
	
	
	
	
	
	
	
	
	
	
	
	
	
	
	
	
	
	
	
	
	
	
	
	
	
	
	
	
	
	
	
	
	
	
	
	
	
	
	
	
	
	
	
	
	
	
	
	
	
	
	
	
	
	
	
	
	
	
	
	
	
	
	
	
	
	
	
	
	
	
	
	
	
	
	
	
	
	
	
	
	
	
	
	
	
	
	
	
	
	
	
	
	
	
	
	
	
	
	
	
	
	
	
	
	
	
	
	
	
	
	
	
	
	
	
	
	
	
	
	
	
	
	
	
	
	
	
	
	
	
	
	
	
	
	
	
	
	
	
	
	
	
	
	
	
	
	
	
	
	
	
	
	
	
	
	
	
	
	
	
	
	
	
	
	
	
	
	
	
	
	
	
	
	
	
	
	
	
	
	
	
	
	
	
	
	
	
	
	
	
	
	
	
	
	
	
	
	
	
	
	
	
	
	
	
	
	
	
	
	
	
	
	
	
	
	
	
	
	
	
	
	
	
	
	
	
	
	
	
	
	
	
	
	
	
	
	
	
	
	
	
	
	
	
	
	
	
	
	
	
	
	
	
	
	
	
	
	
	
	
	
	
	
	
	
	
	
	
	
	
	
	
	
	
	
	
	
	
	
	
	
	
	
	
	
	
	
	
	
	
	
	
	
	
	
	
	
	
	
	
	
	
	
	
	
	
	
	
	
	
	
	
	
	
	
	
	
	
	
	
	
	
	
	
	
	
	
	
	
	
	
	
	
	
	
	
	
	
	
	
	
	
	
	
	
	
	
	
	
	
	
	
	
	
	
	
	
	
	
	
	
	
	
	
	
	
	
	
	
	
	
	
	
	
	
	
	
	
	
	
	
	
	
	
	
	
	
	
	
	
	
	
	
	
	
	
	
	
	
	
	
	
	
	
	
	
	
	
	
	
	
	
	
	
	
	
	
	
	
	
	
	
	
	
	
	
	
	
	
	
	
	
	
	
	
	
	
	
	
	
	
	
	
	
	
	
	
	
	
	
	
	
	
	
	
	
	
	
	
	
	
	
	
	
	
	
	
	
	
	
	
	
	
	
	
	
	
	
	
	
	
	
	
	
	
	
	
	
	
	
	
	
	
	
	
	
	
	
	
	
	
	
	
	
	
	
	
	
	
	
	
	
	
	
	
	
	
	
	
	
	
	
	
	
	
	
	
	
	
	
	
	
	
	
	
	
	
	
	
	
	
	
	
	
	
	
	
	
	
	
	
	
	
	
	
	
	
	
	
	
	
	
	
	
	
	
	
	
	
	
	
	
	
	
	
	
	
	
	
	
	
	
	
	
	
	
	
	
	
	
	
	
	
	
	
	
	
	
	
	
	
	
	
	
	
	
	
	
	
	
	
	
	
	
	
	
	
	
	
	
	
	
	
	
	
	
	
	
	
	
	
	
	
	
	
	
	
	
	
	
	
	
	
	
	
	
	
	
	
	
	
	
	
	
	
	
	
	
	
	
	
	
	
	
	
	
	
	
	
	
	
	
	
	
	
	
	
	
	
	
	
	
	
	
	
	
	
	
	
	
	
	
	
	
	
	
	
	
	
	
	
	
	
	
	
	
	
	
	
	
	
	
	
	
	
	
	
	
	
	
	
	
	
	
	
	
	
	
	
	
	
	
	
	
	
	
	
	
	
	
	
	
	
	
	
	
	
	
	
	
	
	
	
	
	
	
	
	
	
	
	
	
	
	
	
	
	
	
	
	
	
	
	
	
	
	
	
	
	
	
	
	
	
	
	
	
	
	
	
	
	
	
	
	
	
	
	
	
	
	
	
	
	
	
	
	
	
	
	
	
	
	
	
	
	
	
	
	
	
	
	
	
	
	
	
	
	
	
	
	
	
	
	
	
	
	
	
	
	
	
	
	
	
	
	
	
	
	
	
	
	
	
	
	
	
	
	
	
	
	
	
	
	
	
	
	
	
	
	
	
	
	
	
	
	
	
	
	
	
	
	
	
	
	
	
	
	
	
	
	
	
	
	
	
	
	
	
	
	
	
	
	
	
	
	
	
	
	
	
	
	
	
	
	
	
	
	
	
	
	
	
	
	
	
	
	
	
	
	
	
	
	
	
	
	
	
	
	
	
	
	
	
	
	
	
	
	
	
	
	
	
	
	
	
	
	
	
	
	
	
	
	
	
	
	
	
	
	
	
	
	
	
	
	
	
	
	
	
	
	
	
	
	
	
	
	
	
	
	
	
	
	
	
	
	
	
	
	
	
	
	
	
	
	
	
	
	
	
	
	
	
	
	
	
	
	
	
	
	
	
	
	
	
	
	
	
	
	
	
	
	
	
	
	
	
	
	
	
	
	
	
	
	
	
	
	
	
	
	
	
	
	
	
	
	
	
	
	
	
	
	
	
	
	
	
	
	
	
	
	
	
	
	
	
	
	
	
	
	
	
	
	
	
	
	
	
	
	
	
	
	
	
	
	
	
	
	
	
	
	
	
	
	
	
	
	
	
	
	
	
	
	
	
	
	
	
	
	
	
	
	
	
	
	
	
	
	
	
	
	
	
	
	
	
	
	
	
	
	
	
	
	
	
	
	
	
	
	
	
	
	
	
	
	
	
	
	
	
	
	
	
	
	
	
	
	
	
	
	
	
	
	
	
	
	
	
	
	
	
	
	
	
	
	
	
	
	
	
	
	
	
	
	
	
	
	
	
	
	
	
	
	
	
	
	
	
	
	
	
	
	
	
	
	
	
	
	
	
	
	
	
	
	
	
	
	
	
	
	
	
	
	
	
	
	
	
	
	
	
	
	
	
	
	
	
	
	
	
	
	
	
	
	
	
	
	
	
	
	
	
	
	
	
	
	
	
	
	
	
	
	
	
	
	
	
	
	
	
	
	
	
	
	
	
	
	
	
	
	
	
	
	
	
	
	
	
	
	
	
	
	
	
	
	
	
	
	
	
	
	
	
	
	
	
	
	
	
	
	
	
	
	
	
	
	
	
	
	
	
	
	
	
	
	
	
	
	
	
	
	
	
	
	
	
	
	
	
	
	
	
	
	
	
	
	
	
	
	
	
	
	
	
	
	
	
	
	
	
	
	
	
	
	
	
	
	
	
	
	
	
	
	
	
	
	
	
	
	
	
	
	
	
	
	
	
	
	
	
	
	
	
	
	
	
	
	
	
	
	
	
	
	
	
	
	
	
	
	
	
	
	
	
	
	
	
	
	
	
	
	
	
	
	
	
	
	
	
	
	
	
	
	
	
	
	
	
	
	
	
	
	
	
	
	
	
	
	
	
	
	
	
	
	
	
	
	
	
	
	
	
	
	
	
	
	
	
	
	
	
	
	
	
	
	
	
	
	
	
	
	
	
	
	
	
	
	
	
	
	
	
	
	
	
	
	
	
	
	
	
	
	
	
	
	
	
	
	
	
	
	
	
	
	
	
	
	
	
	
	
	
	
	
	
	
	
	
	
	
	
	
	
	
	
	
	
	
	
	
	
	
	
	
	
	
	
	
	
	
	
	
	
	
	
	
	
	
	
	
	
	
	
	
	
	
	
	
	
	
	
	
	
	
	
	
	
	
	
	
	
	
	
	
	
	
	
	
	
	
	
	
	
	
	
	
	
	
	
	
	
	
	
	
	
	
	
	
	
	
	
	
	
	
	
	
	
	
	
	
	
	
	
	
	
	
	
	
	
	
	
	
	
	
	
	
	
	
	
	
	
	
	
	
	
	
	
	
	
	
	
	
	
	
	
	
	
	
	
	
	
	
	
	
	
	
	
	
	
	
	
	
	
	
	
	
	
	
	
	
	
	
	
	
	
	
	
	
	
	
	
	
	
	
	
	
	
	
	
	
	
	
	
	
	
	
	
	
	
	
	
	
	
	
	
	
	
	
	
	
	
	
	
	
	
	
	
	
	
	
	
	
	
	
	
	
	
	
	
	
	
	
	
	
	
	
	
	
	
	
	
	
	
	
	
	
	
	
	
	
	
	
	
	
	
	
	
	
	
	
	
	
	
	
	
	
	
	
	
	
	
	
	
	
	
	
	
	
	
	
	
	
	
	
	
	
	
	
	
	
	
	
	
	
	
	
	
	
	
	
	
	
	
	
	
	
	
	
	
	
	
	
	
	
	
	
	
	
	
	
	
	
	
	
	
	
	
	
	
	
	
	
	
	
	
	
	
	
	
	
	
	
	
	
	
	
	
	
	
	
	
	
	
	
	
	
	
	
	
	
	
	
	
	
	
	
	
	
	
	
	
	
	
	
	
	
	
	
	
	
	
	
	
	
	
	
	
	
	
	
	
	
	
	
	
	
	
	
	
	
	
	
	
	
	
	
	
	
	
	
	
	
	
	
	
	
	
	
	
	
	
	
	
	
	
	
	
	
	
	
	
	
	
	
	
	
	
	
	
	
	
	
	
	
	
	
	
	
	
	
	
	
	
	
	
	
	
	
	
	
	
	
	
	
	
	
	
	
	
	
	
	
	
	
	
	
	
	
	
	
	
	
	
	
	
	
	
	
	
	
	
	
	
	
	
	
	
	
	
	
	
	
	
	
	
	
	
	
	
	
	
	
	
	
	
	
	
	
	
	
	
	
	
	
	
	
	
	
	
	
	
	
	
	
	
	
	
	
	
	
	
	
	
	
	
	
	
	
	
	
	
	
	
	
	
	
	
	
	
	
	
	
	
	
	
	
	
	
	
	
	
	
	
	
	
	
	
	
	
	
	
	
	
	
	
	
	
	
	
	
	
	
	
	
	
	
	
	
	
	
	
	
	
	
	
	
	
	
	
	
	
	
	
	
	
	
	
	
	
	
	
	
	
	
	
	
	
	
	
	
	
	
	
	
	
	
	
	
	
	
	
	
	
	
	
	
	
	
	
	
	
	
	
	
	
	
	
	
	
	
	
	
	
	
	
	
	
	
	
	
	
	
	
	
	
	
	
	
	
	
	
	
	
	
	
	
	
	
	
	
	
	
	
	
	
	
	
	
	
	
	
	
	
	
	
	
	
	
	
	
	
	
	
	
	
	
	
	
	
	
	
	
	
	
	
	
	
	
	
	
	
	
	
	
	
	
	
	
	
	
	
	
	
	
	
	
	
	
	
	
	
	
	
	
	
	
	
	
	
	
	
	
	
	
	
	
	
	
	
	
	
	
	
	
	
	
	
	
	
	
	
	
	
	
	
	
	
	
	
	
	
	
	
	
	
	
	
	
	
	
	
	
	
	
	
	
	
	
	
	
	
	
	
	
	
	
	
	
	
	
	
	
	
	
	
	
	
	
	
	
	
	
	
	
	
	
	
	
	
	
	
	
	
	
	
	
	
	
	
	
	
	
	
	
	
	
	
	
	
	
	
	
	
	
	
	
	
	
	
	
	
	
	
	
	
	
	
	
	
	
	
	
	
	
	
	
	
	
	
	
	
	
	
	
	
	
	
	
	
	
	
	
	
	
	
	
	
	
	
	
	
	
	
	
	
	
	
	
	
	
	
	
	
	
	
	
	
	
	
	
	
	
	
	
	
	
	
	
	
	
	
	
	
	
	
	
	
	
	
	
	
	
	
	
	
